COL name VAL ivar s. nørve COL name_chars VAL i v a r   s .   n ø r v e	COL name VAL ivar nørve COL name_chars VAL i v a r   n ø r v e	1
COL name VAL tore a. heyerdahl COL name_chars VAL t o r e   a .   h e y e r d a h l	COL name VAL tore heyerdahl COL name_chars VAL t o r e   h e y e r d a h l	1
COL name VAL tore j. heyerdahl COL name_chars VAL t o r e   j .   h e y e r d a h l	COL name VAL tore heyerdahl COL name_chars VAL t o r e   h e y e r d a h l	1
COL name VAL peter h. bredal COL name_chars VAL p e t e r   h .   b r e d a l	COL name VAL peter bredal COL name_chars VAL p e t e r   b r e d a l	1
COL name VAL ingeborg c. finnsdóttir COL name_chars VAL i n g e b o r g   c .   f i n n s d ó t t i r	COL name VAL ingeborg finnsdóttir COL name_chars VAL i n g e b o r g   f i n n s d ó t t i r	1
COL name VAL ingeborg m. finnsdóttir COL name_chars VAL i n g e b o r g   m .   f i n n s d ó t t i r	COL name VAL ingeborg finnsdóttir COL name_chars VAL i n g e b o r g   f i n n s d ó t t i r	1
COL name VAL ingeborg w. finnsdóttir COL name_chars VAL i n g e b o r g   w .   f i n n s d ó t t i r	COL name VAL ingeborg finnsdóttir COL name_chars VAL i n g e b o r g   f i n n s d ó t t i r	1
COL name VAL ivar g. nordkild COL name_chars VAL i v a r   g .   n o r d k i l d	COL name VAL ivar nordkild COL name_chars VAL i v a r   n o r d k i l d	1
COL name VAL andrew m. stoltenberg COL name_chars VAL a n d r e w   m .   s t o l t e n b e r g	COL name VAL andrew stoltenberg COL name_chars VAL a n d r e w   s t o l t e n b e r g	1
COL name VAL andrew m. stoltenberg COL name_chars VAL a n d r e w   m .   s t o l t e n b e r g	COL name VAL andrew stoltenberg COL name_chars VAL a n d r e w   s t o l t e n b e r g	1
COL name VAL astrid r  johannessen COL name_chars VAL a s t r i d   r     j o h a n n e s s e n	COL name VAL astrid johannessen COL name_chars VAL a s t r i d   j o h a n n e s s e n	1
COL name VAL vlasta f  vrána COL name_chars VAL v l a s t a   f     v r á n a	COL name VAL vlasta vrána COL name_chars VAL v l a s t a   v r á n a	1
COL name VAL werner x. christie COL name_chars VAL w e r n e r   x .   c h r i s t i e	COL name VAL werner christie COL name_chars VAL w e r n e r   c h r i s t i e	1
COL name VAL bjørn w. heyerdahl COL name_chars VAL b j ø r n   w .   h e y e r d a h l	COL name VAL bjørn heyerdahl COL name_chars VAL b j ø r n   h e y e r d a h l	1
COL name VAL bjørn s  heyerdahl COL name_chars VAL b j ø r n   s     h e y e r d a h l	COL name VAL bjørn heyerdahl COL name_chars VAL b j ø r n   h e y e r d a h l	1
COL name VAL øystein s  halfdansson COL name_chars VAL ø y s t e i n   s     h a l f d a n s s o n	COL name VAL øystein halfdansson COL name_chars VAL ø y s t e i n   h a l f d a n s s o n	1
COL name VAL eystein l  halfdansson COL name_chars VAL e y s t e i n   l     h a l f d a n s s o n	COL name VAL eystein halfdansson COL name_chars VAL e y s t e i n   h a l f d a n s s o n	1
COL name VAL øystein c  halfdansson COL name_chars VAL ø y s t e i n   c     h a l f d a n s s o n	COL name VAL øystein halfdansson COL name_chars VAL ø y s t e i n   h a l f d a n s s o n	1
COL name VAL eystein s  halfdansson COL name_chars VAL e y s t e i n   s     h a l f d a n s s o n	COL name VAL eystein halfdansson COL name_chars VAL e y s t e i n   h a l f d a n s s o n	1
COL name VAL øystein c. halfdansson COL name_chars VAL ø y s t e i n   c .   h a l f d a n s s o n	COL name VAL øystein halfdansson COL name_chars VAL ø y s t e i n   h a l f d a n s s o n	1
COL name VAL eystein f  halfdansson COL name_chars VAL e y s t e i n   f     h a l f d a n s s o n	COL name VAL eystein halfdansson COL name_chars VAL e y s t e i n   h a l f d a n s s o n	1
COL name VAL arne m. røed COL name_chars VAL a r n e   m .   r ø e d	COL name VAL arne røed COL name_chars VAL a r n e   r ø e d	1
COL name VAL arne a  røed COL name_chars VAL a r n e   a     r ø e d	COL name VAL arne røed COL name_chars VAL a r n e   r ø e d	1
COL name VAL arne d  røed COL name_chars VAL a r n e   d     r ø e d	COL name VAL arne røed COL name_chars VAL a r n e   r ø e d	1
COL name VAL camillo w. everardi COL name_chars VAL c a m i l l o   w .   e v e r a r d i	COL name VAL camillo everardi COL name_chars VAL c a m i l l o   e v e r a r d i	1
COL name VAL camille j. everardi COL name_chars VAL c a m i l l e   j .   e v e r a r d i	COL name VAL camille everardi COL name_chars VAL c a m i l l e   e v e r a r d i	1
COL name VAL alexandra s. joner COL name_chars VAL a l e x a n d r a   s .   j o n e r	COL name VAL alexandra joner COL name_chars VAL a l e x a n d r a   j o n e r	1
COL name VAL solfrid p. heier COL name_chars VAL s o l f r i d   p .   h e i e r	COL name VAL solfrid heier COL name_chars VAL s o l f r i d   h e i e r	1
COL name VAL christophe s. schatteman COL name_chars VAL c h r i s t o p h e   s .   s c h a t t e m a n	COL name VAL christophe schatteman COL name_chars VAL c h r i s t o p h e   s c h a t t e m a n	1
COL name VAL erik h  schjerven COL name_chars VAL e r i k   h     s c h j e r v e n	COL name VAL erik schjerven COL name_chars VAL e r i k   s c h j e r v e n	1
COL name VAL gard c. eidsvold COL name_chars VAL g a r d   c .   e i d s v o l d	COL name VAL gard eidsvold COL name_chars VAL g a r d   e i d s v o l d	1
COL name VAL bjørnstjerne t. eidsvold COL name_chars VAL b j ø r n s t j e r n e   t .   e i d s v o l d	COL name VAL bjørnstjerne eidsvold COL name_chars VAL b j ø r n s t j e r n e   e i d s v o l d	1
COL name VAL harry c  lien COL name_chars VAL h a r r y   c     l i e n	COL name VAL harry lien COL name_chars VAL h a r r y   l i e n	1
COL name VAL olaf t. tryggvason COL name_chars VAL o l a f   t .   t r y g g v a s o n	COL name VAL olaf tryggvason COL name_chars VAL o l a f   t r y g g v a s o n	1
COL name VAL victor b. verschueren COL name_chars VAL v i c t o r   b .   v e r s c h u e r e n	COL name VAL victor verschueren COL name_chars VAL v i c t o r   v e r s c h u e r e n	1
COL name VAL paulette n  cooper COL name_chars VAL p a u l e t t e   n     c o o p e r	COL name VAL paulette cooper COL name_chars VAL p a u l e t t e   c o o p e r	1
COL name VAL august m  olsen COL name_chars VAL a u g u s t   m     o l s e n	COL name VAL august olsen COL name_chars VAL a u g u s t   o l s e n	1
COL name VAL cecilie s. mosli COL name_chars VAL c e c i l i e   s .   m o s l i	COL name VAL cecilie mosli COL name_chars VAL c e c i l i e   m o s l i	1
COL name VAL cecilie a. mosli COL name_chars VAL c e c i l i e   a .   m o s l i	COL name VAL cecilie mosli COL name_chars VAL c e c i l i e   m o s l i	1
COL name VAL sondre k. tronstad COL name_chars VAL s o n d r e   k .   t r o n s t a d	COL name VAL sondre tronstad COL name_chars VAL s o n d r e   t r o n s t a d	1
COL name VAL truls j. korsæth COL name_chars VAL t r u l s   j .   k o r s æ t h	COL name VAL truls korsæth COL name_chars VAL t r u l s   k o r s æ t h	1
COL name VAL truls a  korsæth COL name_chars VAL t r u l s   a     k o r s æ t h	COL name VAL truls korsæth COL name_chars VAL t r u l s   k o r s æ t h	1
COL name VAL truls g  korsæth COL name_chars VAL t r u l s   g     k o r s æ t h	COL name VAL truls korsæth COL name_chars VAL t r u l s   k o r s æ t h	1
COL name VAL tone h. lima COL name_chars VAL t o n e   h .   l i m a	COL name VAL tone lima COL name_chars VAL t o n e   l i m a	1
COL name VAL ingrid m  wold COL name_chars VAL i n g r i d   m     w o l d	COL name VAL ingrid wold COL name_chars VAL i n g r i d   w o l d	1
COL name VAL henning f. olsen COL name_chars VAL h e n n i n g   f .   o l s e n	COL name VAL henning olsen COL name_chars VAL h e n n i n g   o l s e n	1
COL name VAL magnus d. eriksson COL name_chars VAL m a g n u s   d .   e r i k s s o n	COL name VAL magnus eriksson COL name_chars VAL m a g n u s   e r i k s s o n	1
COL name VAL maunu e  eriksson COL name_chars VAL m a u n u   e     e r i k s s o n	COL name VAL maunu eriksson COL name_chars VAL m a u n u   e r i k s s o n	1
COL name VAL magnus r  eriksson COL name_chars VAL m a g n u s   r     e r i k s s o n	COL name VAL magnus eriksson COL name_chars VAL m a g n u s   e r i k s s o n	1
COL name VAL maunu r. eriksson COL name_chars VAL m a u n u   r .   e r i k s s o n	COL name VAL maunu eriksson COL name_chars VAL m a u n u   e r i k s s o n	1
COL name VAL øystein a. magnusson COL name_chars VAL ø y s t e i n   a .   m a g n u s s o n	COL name VAL øystein magnusson COL name_chars VAL ø y s t e i n   m a g n u s s o n	1
COL name VAL eysteinn j. magnusson COL name_chars VAL e y s t e i n n   j .   m a g n u s s o n	COL name VAL eysteinn magnusson COL name_chars VAL e y s t e i n n   m a g n u s s o n	1
COL name VAL sigurd f. munn COL name_chars VAL s i g u r d   f .   m u n n	COL name VAL sigurd munn COL name_chars VAL s i g u r d   m u n n	1
COL name VAL sigurd t. munn COL name_chars VAL s i g u r d   t .   m u n n	COL name VAL sigurd munn COL name_chars VAL s i g u r d   m u n n	1
COL name VAL sigurd c  munn COL name_chars VAL s i g u r d   c     m u n n	COL name VAL sigurd munn COL name_chars VAL s i g u r d   m u n n	1
COL name VAL gunnbjörn v  ulfsson COL name_chars VAL g u n n b j ö r n   v     u l f s s o n	COL name VAL gunnbjörn ulfsson COL name_chars VAL g u n n b j ö r n   u l f s s o n	1
COL name VAL stéphanie w  van vyve COL name_chars VAL s t é p h a n i e   w     v a n   v y v e	COL name VAL stéphanie van vyve COL name_chars VAL s t é p h a n i e   v a n   v y v e	1
COL name VAL vivian j  miessen COL name_chars VAL v i v i a n   j     m i e s s e n	COL name VAL vivian miessen COL name_chars VAL v i v i a n   m i e s s e n	1
COL name VAL arnt c  grønbech COL name_chars VAL a r n t   c     g r ø n b e c h	COL name VAL arnt grønbech COL name_chars VAL a r n t   g r ø n b e c h	1
COL name VAL jarl j. goli COL name_chars VAL j a r l   j .   g o l i	COL name VAL jarl goli COL name_chars VAL j a r l   g o l i	1
COL name VAL arnaud c. borchgrave COL name_chars VAL a r n a u d   c .   b o r c h g r a v e	COL name VAL arnaud borchgrave COL name_chars VAL a r n a u d   b o r c h g r a v e	1
COL name VAL arnoud d  de meyer COL name_chars VAL a r n o u d   d     d e   m e y e r	COL name VAL arnoud de meyer COL name_chars VAL a r n o u d   d e   m e y e r	1
COL name VAL albert j  blanc COL name_chars VAL a l b e r t   j     b l a n c	COL name VAL albert blanc COL name_chars VAL a l b e r t   b l a n c	1
COL name VAL john c. robson COL name_chars VAL j o h n   c .   r o b s o n	COL name VAL john robson COL name_chars VAL j o h n   r o b s o n	1
COL name VAL ivan e. robson COL name_chars VAL i v a n   e .   r o b s o n	COL name VAL ivan robson COL name_chars VAL i v a n   r o b s o n	1
COL name VAL john k  robson COL name_chars VAL j o h n   k     r o b s o n	COL name VAL john robson COL name_chars VAL j o h n   r o b s o n	1
COL name VAL ivan j. robson COL name_chars VAL i v a n   j .   r o b s o n	COL name VAL ivan robson COL name_chars VAL i v a n   r o b s o n	1
COL name VAL john p  robson COL name_chars VAL j o h n   p     r o b s o n	COL name VAL john robson COL name_chars VAL j o h n   r o b s o n	1
COL name VAL ivan c. robson COL name_chars VAL i v a n   c .   r o b s o n	COL name VAL ivan robson COL name_chars VAL i v a n   r o b s o n	1
COL name VAL lise a  nøstvold COL name_chars VAL l i s e   a     n ø s t v o l d	COL name VAL lise nøstvold COL name_chars VAL l i s e   n ø s t v o l d	1
COL name VAL lise j  nøstvold COL name_chars VAL l i s e   j     n ø s t v o l d	COL name VAL lise nøstvold COL name_chars VAL l i s e   n ø s t v o l d	1
COL name VAL lise j. nøstvold COL name_chars VAL l i s e   j .   n ø s t v o l d	COL name VAL lise nøstvold COL name_chars VAL l i s e   n ø s t v o l d	1
COL name VAL kari j. grønsund COL name_chars VAL k a r i   j .   g r ø n s u n d	COL name VAL kari grønsund COL name_chars VAL k a r i   g r ø n s u n d	1
COL name VAL håkon d  ericsson COL name_chars VAL h å k o n   d     e r i c s s o n	COL name VAL håkon ericsson COL name_chars VAL h å k o n   e r i c s s o n	1
COL name VAL eystein r  magnusson COL name_chars VAL e y s t e i n   r     m a g n u s s o n	COL name VAL eystein magnusson COL name_chars VAL e y s t e i n   m a g n u s s o n	1
COL name VAL øivind t. blunck COL name_chars VAL ø i v i n d   t .   b l u n c k	COL name VAL øivind blunck COL name_chars VAL ø i v i n d   b l u n c k	1
COL name VAL magnus m  barfod COL name_chars VAL m a g n u s   m     b a r f o d	COL name VAL magnus barfod COL name_chars VAL m a g n u s   b a r f o d	1
COL name VAL ragnhild r. mikkelsen COL name_chars VAL r a g n h i l d   r .   m i k k e l s e n	COL name VAL ragnhild mikkelsen COL name_chars VAL r a g n h i l d   m i k k e l s e n	1
COL name VAL helene g. goudin COL name_chars VAL h e l e n e   g .   g o u d i n	COL name VAL helene goudin COL name_chars VAL h e l e n e   g o u d i n	1
COL name VAL claire m. goudin COL name_chars VAL c l a i r e   m .   g o u d i n	COL name VAL claire goudin COL name_chars VAL c l a i r e   g o u d i n	1
COL name VAL henry g  van den bulcke COL name_chars VAL h e n r y   g     v a n   d e n   b u l c k e	COL name VAL henry van den bulcke COL name_chars VAL h e n r y   v a n   d e n   b u l c k e	1
COL name VAL jozef d  roey COL name_chars VAL j o z e f   d     r o e y	COL name VAL jozef roey COL name_chars VAL j o z e f   r o e y	1
COL name VAL ernest h  roey COL name_chars VAL e r n e s t   h     r o e y	COL name VAL ernest roey COL name_chars VAL e r n e s t   r o e y	1
COL name VAL jozef g. roey COL name_chars VAL j o z e f   g .   r o e y	COL name VAL jozef roey COL name_chars VAL j o z e f   r o e y	1
COL name VAL ernest l. roey COL name_chars VAL e r n e s t   l .   r o e y	COL name VAL ernest roey COL name_chars VAL e r n e s t   r o e y	1
COL name VAL liv l. løberg COL name_chars VAL l i v   l .   l ø b e r g	COL name VAL liv løberg COL name_chars VAL l i v   l ø b e r g	1
COL name VAL liv e  løberg COL name_chars VAL l i v   e     l ø b e r g	COL name VAL liv løberg COL name_chars VAL l i v   l ø b e r g	1
COL name VAL liv l. løberg COL name_chars VAL l i v   l .   l ø b e r g	COL name VAL liv løberg COL name_chars VAL l i v   l ø b e r g	1
COL name VAL stian b  ringstad COL name_chars VAL s t i a n   b     r i n g s t a d	COL name VAL stian ringstad COL name_chars VAL s t i a n   r i n g s t a d	1
COL name VAL ánde c  somby COL name_chars VAL á n d e   c     s o m b y	COL name VAL ánde somby COL name_chars VAL á n d e   s o m b y	1
COL name VAL a. d  westgard COL name_chars VAL a .   d     w e s t g a r d	COL name VAL a. westgard COL name_chars VAL a .   w e s t g a r d	1
COL name VAL siri j  nordby COL name_chars VAL s i r i   j     n o r d b y	COL name VAL siri nordby COL name_chars VAL s i r i   n o r d b y	1
COL name VAL siri s. nordby COL name_chars VAL s i r i   s .   n o r d b y	COL name VAL siri nordby COL name_chars VAL s i r i   n o r d b y	1
COL name VAL ole r. halvorsen COL name_chars VAL o l e   r .   h a l v o r s e n	COL name VAL ole halvorsen COL name_chars VAL o l e   h a l v o r s e n	1
COL name VAL yurii d  luhovyj COL name_chars VAL y u r i i   d     l u h o v y j	COL name VAL yurii luhovyj COL name_chars VAL y u r i i   l u h o v y j	1
COL name VAL yurii j  luhovyj COL name_chars VAL y u r i i   j     l u h o v y j	COL name VAL yurii luhovyj COL name_chars VAL y u r i i   l u h o v y j	1
COL name VAL yurii j  luhovyj COL name_chars VAL y u r i i   j     l u h o v y j	COL name VAL yurii luhovyj COL name_chars VAL y u r i i   l u h o v y j	1
COL name VAL henrik s. bjørdal COL name_chars VAL h e n r i k   s .   b j ø r d a l	COL name VAL henrik bjørdal COL name_chars VAL h e n r i k   b j ø r d a l	1
COL name VAL ole e. skjelbred-knutsen COL name_chars VAL o l e   e .   s k j e l b r e d - k n u t s e n	COL name VAL ole skjelbred-knutsen COL name_chars VAL o l e   s k j e l b r e d - k n u t s e n	1
COL name VAL henri s  van den bulcke COL name_chars VAL h e n r i   s     v a n   d e n   b u l c k e	COL name VAL henri van den bulcke COL name_chars VAL h e n r i   v a n   d e n   b u l c k e	1
COL name VAL harald i  paalgard COL name_chars VAL h a r a l d   i     p a a l g a r d	COL name VAL harald paalgard COL name_chars VAL h a r a l d   p a a l g a r d	1
COL name VAL bente a  nordby COL name_chars VAL b e n t e   a     n o r d b y	COL name VAL bente nordby COL name_chars VAL b e n t e   n o r d b y	1
COL name VAL titti b  maartmann COL name_chars VAL t i t t i   b     m a a r t m a n n	COL name VAL titti maartmann COL name_chars VAL t i t t i   m a a r t m a n n	1
COL name VAL engelbert l  sterckx COL name_chars VAL e n g e l b e r t   l     s t e r c k x	COL name VAL engelbert sterckx COL name_chars VAL e n g e l b e r t   s t e r c k x	1
COL name VAL engelbert c  sterckx COL name_chars VAL e n g e l b e r t   c     s t e r c k x	COL name VAL engelbert sterckx COL name_chars VAL e n g e l b e r t   s t e r c k x	1
COL name VAL kim m. huybrechts COL name_chars VAL k i m   m .   h u y b r e c h t s	COL name VAL kim huybrechts COL name_chars VAL k i m   h u y b r e c h t s	1
COL name VAL martin h  torp COL name_chars VAL m a r t i n   h     t o r p	COL name VAL martin torp COL name_chars VAL m a r t i n   t o r p	1
COL name VAL pierre t. lagrange COL name_chars VAL p i e r r e   t .   l a g r a n g e	COL name VAL pierre lagrange COL name_chars VAL p i e r r e   l a g r a n g e	1
COL name VAL johan j. schwartz COL name_chars VAL j o h a n   j .   s c h w a r t z	COL name VAL johan schwartz COL name_chars VAL j o h a n   s c h w a r t z	1
COL name VAL eline a. brustad COL name_chars VAL e l i n e   a .   b r u s t a d	COL name VAL eline brustad COL name_chars VAL e l i n e   b r u s t a d	1
COL name VAL petter m  strand COL name_chars VAL p e t t e r   m     s t r a n d	COL name VAL petter strand COL name_chars VAL p e t t e r   s t r a n d	1
COL name VAL aryan j  tari COL name_chars VAL a r y a n   j     t a r i	COL name VAL aryan tari COL name_chars VAL a r y a n   t a r i	1
COL name VAL carlos n. cañas COL name_chars VAL c a r l o s   n .   c a ñ a s	COL name VAL carlos cañas COL name_chars VAL c a r l o s   c a ñ a s	1
COL name VAL guri e. schanke COL name_chars VAL g u r i   e .   s c h a n k e	COL name VAL guri schanke COL name_chars VAL g u r i   s c h a n k e	1
COL name VAL annika s  schanke COL name_chars VAL a n n i k a   s     s c h a n k e	COL name VAL annika schanke COL name_chars VAL a n n i k a   s c h a n k e	1
COL name VAL frøydis t  wærsted COL name_chars VAL f r ø y d i s   t     w æ r s t e d	COL name VAL frøydis wærsted COL name_chars VAL f r ø y d i s   w æ r s t e d	1
COL name VAL frøydis s  wærsted COL name_chars VAL f r ø y d i s   s     w æ r s t e d	COL name VAL frøydis wærsted COL name_chars VAL f r ø y d i s   w æ r s t e d	1
COL name VAL frøydis a  wærsted COL name_chars VAL f r ø y d i s   a     w æ r s t e d	COL name VAL frøydis wærsted COL name_chars VAL f r ø y d i s   w æ r s t e d	1
COL name VAL hugo w  munthe-kaas COL name_chars VAL h u g o   w     m u n t h e - k a a s	COL name VAL hugo munthe-kaas COL name_chars VAL h u g o   m u n t h e - k a a s	1
COL name VAL kjetil j  try COL name_chars VAL k j e t i l   j     t r y	COL name VAL kjetil try COL name_chars VAL k j e t i l   t r y	1
COL name VAL amélie r  rorty COL name_chars VAL a m é l i e   r     r o r t y	COL name VAL amélie rorty COL name_chars VAL a m é l i e   r o r t y	1
COL name VAL amélie o. rorty COL name_chars VAL a m é l i e   o .   r o r t y	COL name VAL amélie rorty COL name_chars VAL a m é l i e   r o r t y	1
COL name VAL arne j. eggum COL name_chars VAL a r n e   j .   e g g u m	COL name VAL arne eggum COL name_chars VAL a r n e   e g g u m	1
COL name VAL lage c. lund COL name_chars VAL l a g e   c .   l u n d	COL name VAL lage lund COL name_chars VAL l a g e   l u n d	1
COL name VAL alain t  dehaze COL name_chars VAL a l a i n   t     d e h a z e	COL name VAL alain dehaze COL name_chars VAL a l a i n   d e h a z e	1
COL name VAL francisco m  cereijo COL name_chars VAL f r a n c i s c o   m     c e r e i j o	COL name VAL francisco cereijo COL name_chars VAL f r a n c i s c o   c e r e i j o	1
COL name VAL francisco a  cereijo COL name_chars VAL f r a n c i s c o   a     c e r e i j o	COL name VAL francisco cereijo COL name_chars VAL f r a n c i s c o   c e r e i j o	1
COL name VAL joaquín a  cañas COL name_chars VAL j o a q u í n   a     c a ñ a s	COL name VAL joaquín cañas COL name_chars VAL j o a q u í n   c a ñ a s	1
COL name VAL marcel h. fässler COL name_chars VAL m a r c e l   h .   f ä s s l e r	COL name VAL marcel fässler COL name_chars VAL m a r c e l   f ä s s l e r	1
COL name VAL daniel s  müller COL name_chars VAL d a n i e l   s     m ü l l e r	COL name VAL daniel müller COL name_chars VAL d a n i e l   m ü l l e r	1
COL name VAL ditlev d. vibe COL name_chars VAL d i t l e v   d .   v i b e	COL name VAL ditlev vibe COL name_chars VAL d i t l e v   v i b e	1
COL name VAL peder d  andersen COL name_chars VAL p e d e r   d     a n d e r s e n	COL name VAL peder andersen COL name_chars VAL p e d e r   a n d e r s e n	1
COL name VAL mina r. holtmann COL name_chars VAL m i n a   r .   h o l t m a n n	COL name VAL mina holtmann COL name_chars VAL m i n a   h o l t m a n n	1
COL name VAL mina a  holtmann COL name_chars VAL m i n a   a     h o l t m a n n	COL name VAL mina holtmann COL name_chars VAL m i n a   h o l t m a n n	1
COL name VAL fredrik m  galta COL name_chars VAL f r e d r i k   m     g a l t a	COL name VAL fredrik galta COL name_chars VAL f r e d r i k   g a l t a	1
COL name VAL anke k  vanhooren COL name_chars VAL a n k e   k     v a n h o o r e n	COL name VAL anke vanhooren COL name_chars VAL a n k e   v a n h o o r e n	1
COL name VAL antonio k. suñol COL name_chars VAL a n t o n i o   k .   s u ñ o l	COL name VAL antonio suñol COL name_chars VAL a n t o n i o   s u ñ o l	1
COL name VAL antonio l. suñol COL name_chars VAL a n t o n i o   l .   s u ñ o l	COL name VAL antonio suñol COL name_chars VAL a n t o n i o   s u ñ o l	1
COL name VAL antonio m  suñol COL name_chars VAL a n t o n i o   m     s u ñ o l	COL name VAL antonio suñol COL name_chars VAL a n t o n i o   s u ñ o l	1
COL name VAL antonio k  suñol COL name_chars VAL a n t o n i o   k     s u ñ o l	COL name VAL antonio suñol COL name_chars VAL a n t o n i o   s u ñ o l	1
COL name VAL gustavo j. fernández COL name_chars VAL g u s t a v o   j .   f e r n á n d e z	COL name VAL gustavo fernández COL name_chars VAL g u s t a v o   f e r n á n d e z	1
COL name VAL valeria g. pacheco COL name_chars VAL v a l e r i a   g .   p a c h e c o	COL name VAL valeria pacheco COL name_chars VAL v a l e r i a   p a c h e c o	1
COL name VAL óscar r. vizcaíno COL name_chars VAL ó s c a r   r .   v i z c a í n o	COL name VAL óscar vizcaíno COL name_chars VAL ó s c a r   v i z c a í n o	1
COL name VAL óscar r  vizcaíno COL name_chars VAL ó s c a r   r     v i z c a í n o	COL name VAL óscar vizcaíno COL name_chars VAL ó s c a r   v i z c a í n o	1
COL name VAL óscar j  vizcaíno COL name_chars VAL ó s c a r   j     v i z c a í n o	COL name VAL óscar vizcaíno COL name_chars VAL ó s c a r   v i z c a í n o	1
COL name VAL óscar d. vizcaíno COL name_chars VAL ó s c a r   d .   v i z c a í n o	COL name VAL óscar vizcaíno COL name_chars VAL ó s c a r   v i z c a í n o	1
COL name VAL óscar m  vizcaíno COL name_chars VAL ó s c a r   m     v i z c a í n o	COL name VAL óscar vizcaíno COL name_chars VAL ó s c a r   v i z c a í n o	1
COL name VAL valeria e. antolino COL name_chars VAL v a l e r i a   e .   a n t o l i n o	COL name VAL valeria antolino COL name_chars VAL v a l e r i a   a n t o l i n o	1
COL name VAL gustavo g. huertas COL name_chars VAL g u s t a v o   g .   h u e r t a s	COL name VAL gustavo huertas COL name_chars VAL g u s t a v o   h u e r t a s	1
COL name VAL eysteinn e  erlendsson COL name_chars VAL e y s t e i n n   e     e r l e n d s s o n	COL name VAL eysteinn erlendsson COL name_chars VAL e y s t e i n n   e r l e n d s s o n	1
COL name VAL eysteinn g  erlendsson COL name_chars VAL e y s t e i n n   g     e r l e n d s s o n	COL name VAL eysteinn erlendsson COL name_chars VAL e y s t e i n n   e r l e n d s s o n	1
COL name VAL eysteinn n. erlendsson COL name_chars VAL e y s t e i n n   n .   e r l e n d s s o n	COL name VAL eysteinn erlendsson COL name_chars VAL e y s t e i n n   e r l e n d s s o n	1
COL name VAL eysteinn a  erlendsson COL name_chars VAL e y s t e i n n   a     e r l e n d s s o n	COL name VAL eysteinn erlendsson COL name_chars VAL e y s t e i n n   e r l e n d s s o n	1
COL name VAL pål h. johannessen COL name_chars VAL p å l   h .   j o h a n n e s s e n	COL name VAL pål johannessen COL name_chars VAL p å l   j o h a n n e s s e n	1
COL name VAL petter j  olsen COL name_chars VAL p e t t e r   j     o l s e n	COL name VAL petter olsen COL name_chars VAL p e t t e r   o l s e n	1
COL name VAL yōhei a  miyake COL name_chars VAL y ō h e i   a     m i y a k e	COL name VAL yōhei miyake COL name_chars VAL y ō h e i   m i y a k e	1
COL name VAL yōhei b  miyake COL name_chars VAL y ō h e i   b     m i y a k e	COL name VAL yōhei miyake COL name_chars VAL y ō h e i   m i y a k e	1
COL name VAL akinsola s. akinyemi COL name_chars VAL a k i n s o l a   s .   a k i n y e m i	COL name VAL akinsola akinyemi COL name_chars VAL a k i n s o l a   a k i n y e m i	1
COL name VAL akinsola s. akinyemi COL name_chars VAL a k i n s o l a   s .   a k i n y e m i	COL name VAL akinsola akinyemi COL name_chars VAL a k i n s o l a   a k i n y e m i	1
COL name VAL dilşad j. şimşek COL name_chars VAL d i l ş a d   j .   ş i m ş e k	COL name VAL dilşad şimşek COL name_chars VAL d i l ş a d   ş i m ş e k	1
COL name VAL renee a  ginsberg COL name_chars VAL r e n e e   a     g i n s b e r g	COL name VAL renee ginsberg COL name_chars VAL r e n e e   g i n s b e r g	1
COL name VAL renee e. rabinowitz COL name_chars VAL r e n e e   e .   r a b i n o w i t z	COL name VAL renee rabinowitz COL name_chars VAL r e n e e   r a b i n o w i t z	1
COL name VAL umberto l  cordani COL name_chars VAL u m b e r t o   l     c o r d a n i	COL name VAL umberto cordani COL name_chars VAL u m b e r t o   c o r d a n i	1
COL name VAL francisco g  lucini COL name_chars VAL f r a n c i s c o   g     l u c i n i	COL name VAL francisco lucini COL name_chars VAL f r a n c i s c o   l u c i n i	1
COL name VAL francisco m  lucini COL name_chars VAL f r a n c i s c o   m     l u c i n i	COL name VAL francisco lucini COL name_chars VAL f r a n c i s c o   l u c i n i	1
COL name VAL juan v. pulido COL name_chars VAL j u a n   v .   p u l i d o	COL name VAL juan pulido COL name_chars VAL j u a n   p u l i d o	1
COL name VAL yolanda r  heras COL name_chars VAL y o l a n d a   r     h e r a s	COL name VAL yolanda heras COL name_chars VAL y o l a n d a   h e r a s	1
COL name VAL blanca a  hualde COL name_chars VAL b l a n c a   a     h u a l d e	COL name VAL blanca hualde COL name_chars VAL b l a n c a   h u a l d e	1
COL name VAL maria m. suñol COL name_chars VAL m a r i a   m .   s u ñ o l	COL name VAL maria suñol COL name_chars VAL m a r i a   s u ñ o l	1
COL name VAL maria s. suñol COL name_chars VAL m a r i a   s .   s u ñ o l	COL name VAL maria suñol COL name_chars VAL m a r i a   s u ñ o l	1
COL name VAL maria g. suñol COL name_chars VAL m a r i a   g .   s u ñ o l	COL name VAL maria suñol COL name_chars VAL m a r i a   s u ñ o l	1
COL name VAL maria l. suñol COL name_chars VAL m a r i a   l .   s u ñ o l	COL name VAL maria suñol COL name_chars VAL m a r i a   s u ñ o l	1
COL name VAL yossi c  peled COL name_chars VAL y o s s i   c     p e l e d	COL name VAL yossi peled COL name_chars VAL y o s s i   p e l e d	1
COL name VAL yossi j. peled COL name_chars VAL y o s s i   j .   p e l e d	COL name VAL yossi peled COL name_chars VAL y o s s i   p e l e d	1
COL name VAL alexis b. scholl COL name_chars VAL a l e x i s   b .   s c h o l l	COL name VAL alexis scholl COL name_chars VAL a l e x i s   s c h o l l	1
COL name VAL andreas t. hanche-olsen COL name_chars VAL a n d r e a s   t .   h a n c h e - o l s e n	COL name VAL andreas hanche-olsen COL name_chars VAL a n d r e a s   h a n c h e - o l s e n	1
COL name VAL vinny m. lauwers COL name_chars VAL v i n n y   m .   l a u w e r s	COL name VAL vinny lauwers COL name_chars VAL v i n n y   l a u w e r s	1
COL name VAL alexis r  lefrançois COL name_chars VAL a l e x i s   r     l e f r a n ç o i s	COL name VAL alexis lefrançois COL name_chars VAL a l e x i s   l e f r a n ç o i s	1
COL name VAL maría victoria g  mateos COL name_chars VAL m a r í a   v i c t o r i a   g     m a t e o s	COL name VAL maría victoria mateos COL name_chars VAL m a r í a   v i c t o r i a   m a t e o s	1
COL name VAL maría victoria b. mateos COL name_chars VAL m a r í a   v i c t o r i a   b .   m a t e o s	COL name VAL maría victoria mateos COL name_chars VAL m a r í a   v i c t o r i a   m a t e o s	1
COL name VAL delfina s  entrecanales COL name_chars VAL d e l f i n a   s     e n t r e c a n a l e s	COL name VAL delfina entrecanales COL name_chars VAL d e l f i n a   e n t r e c a n a l e s	1
COL name VAL delfina p. entrecanales COL name_chars VAL d e l f i n a   p .   e n t r e c a n a l e s	COL name VAL delfina entrecanales COL name_chars VAL d e l f i n a   e n t r e c a n a l e s	1
COL name VAL henrik c. christiansen COL name_chars VAL h e n r i k   c .   c h r i s t i a n s e n	COL name VAL henrik christiansen COL name_chars VAL h e n r i k   c h r i s t i a n s e n	1
COL name VAL henrik g. christiansen COL name_chars VAL h e n r i k   g .   c h r i s t i a n s e n	COL name VAL henrik christiansen COL name_chars VAL h e n r i k   c h r i s t i a n s e n	1
COL name VAL jakob w  bagge COL name_chars VAL j a k o b   w     b a g g e	COL name VAL jakob bagge COL name_chars VAL j a k o b   b a g g e	1
COL name VAL håvard m. nybø COL name_chars VAL h å v a r d   m .   n y b ø	COL name VAL håvard nybø COL name_chars VAL h å v a r d   n y b ø	1
COL name VAL emil f. filliol COL name_chars VAL e m i l   f .   f i l l i o l	COL name VAL emil filliol COL name_chars VAL e m i l   f i l l i o l	1
COL name VAL erik d  steen COL name_chars VAL e r i k   d     s t e e n	COL name VAL erik steen COL name_chars VAL e r i k   s t e e n	1
COL name VAL magnus c  grødem COL name_chars VAL m a g n u s   c     g r ø d e m	COL name VAL magnus grødem COL name_chars VAL m a g n u s   g r ø d e m	1
COL name VAL marcella d  jackson COL name_chars VAL m a r c e l l a   d     j a c k s o n	COL name VAL marcella jackson COL name_chars VAL m a r c e l l a   j a c k s o n	1
COL name VAL mary a  jackson COL name_chars VAL m a r y   a     j a c k s o n	COL name VAL mary jackson COL name_chars VAL m a r y   j a c k s o n	1
COL name VAL marcella s  jackson COL name_chars VAL m a r c e l l a   s     j a c k s o n	COL name VAL marcella jackson COL name_chars VAL m a r c e l l a   j a c k s o n	1
COL name VAL mary l. jackson COL name_chars VAL m a r y   l .   j a c k s o n	COL name VAL mary jackson COL name_chars VAL m a r y   j a c k s o n	1
COL name VAL pol g  lozano COL name_chars VAL p o l   g     l o z a n o	COL name VAL pol lozano COL name_chars VAL p o l   l o z a n o	1
COL name VAL claudia r  cividino COL name_chars VAL c l a u d i a   r     c i v i d i n o	COL name VAL claudia cividino COL name_chars VAL c l a u d i a   c i v i d i n o	1
COL name VAL claudia j. cividino COL name_chars VAL c l a u d i a   j .   c i v i d i n o	COL name VAL claudia cividino COL name_chars VAL c l a u d i a   c i v i d i n o	1
COL name VAL cristina o. montijano COL name_chars VAL c r i s t i n a   o .   m o n t i j a n o	COL name VAL cristina montijano COL name_chars VAL c r i s t i n a   m o n t i j a n o	1
COL name VAL juan m  jiménez COL name_chars VAL j u a n   m     j i m é n e z	COL name VAL juan jiménez COL name_chars VAL j u a n   j i m é n e z	1
COL name VAL genaro g. gamboa COL name_chars VAL g e n a r o   g .   g a m b o a	COL name VAL genaro gamboa COL name_chars VAL g e n a r o   g a m b o a	1
COL name VAL gabriel c. jiménez COL name_chars VAL g a b r i e l   c .   j i m é n e z	COL name VAL gabriel jiménez COL name_chars VAL g a b r i e l   j i m é n e z	1
COL name VAL erik g. wollen COL name_chars VAL e r i k   g .   w o l l e n	COL name VAL erik wollen COL name_chars VAL e r i k   w o l l e n	1
COL name VAL carolina j  montijano COL name_chars VAL c a r o l i n a   j     m o n t i j a n o	COL name VAL carolina montijano COL name_chars VAL c a r o l i n a   m o n t i j a n o	1
COL name VAL andré j. christiansen COL name_chars VAL a n d r é   j .   c h r i s t i a n s e n	COL name VAL andré christiansen COL name_chars VAL a n d r é   c h r i s t i a n s e n	1
COL name VAL andré c  christiansen COL name_chars VAL a n d r é   c     c h r i s t i a n s e n	COL name VAL andré christiansen COL name_chars VAL a n d r é   c h r i s t i a n s e n	1
COL name VAL sven r. kristiansen COL name_chars VAL s v e n   r .   k r i s t i a n s e n	COL name VAL sven kristiansen COL name_chars VAL s v e n   k r i s t i a n s e n	1
COL name VAL peter m  schärer COL name_chars VAL p e t e r   m     s c h ä r e r	COL name VAL peter schärer COL name_chars VAL p e t e r   s c h ä r e r	1
COL name VAL samy h  mmaee COL name_chars VAL s a m y   h     m m a e e	COL name VAL samy mmaee COL name_chars VAL s a m y   m m a e e	1
COL name VAL morten j  solvik COL name_chars VAL m o r t e n   j     s o l v i k	COL name VAL morten solvik COL name_chars VAL m o r t e n   s o l v i k	1
COL name VAL morten d  solvik COL name_chars VAL m o r t e n   d     s o l v i k	COL name VAL morten solvik COL name_chars VAL m o r t e n   s o l v i k	1
COL name VAL iselin d  solheim COL name_chars VAL i s e l i n   d     s o l h e i m	COL name VAL iselin solheim COL name_chars VAL i s e l i n   s o l h e i m	1
COL name VAL maria m. sarro COL name_chars VAL m a r i a   m .   s a r r o	COL name VAL maria sarro COL name_chars VAL m a r i a   s a r r o	1
COL name VAL maria w. sarro COL name_chars VAL m a r i a   w .   s a r r o	COL name VAL maria sarro COL name_chars VAL m a r i a   s a r r o	1
COL name VAL maria a. sarro COL name_chars VAL m a r i a   a .   s a r r o	COL name VAL maria sarro COL name_chars VAL m a r i a   s a r r o	1
COL name VAL maria m. sarro COL name_chars VAL m a r i a   m .   s a r r o	COL name VAL maria sarro COL name_chars VAL m a r i a   s a r r o	1
COL name VAL maria m. martinetti COL name_chars VAL m a r i a   m .   m a r t i n e t t i	COL name VAL maria martinetti COL name_chars VAL m a r i a   m a r t i n e t t i	1
COL name VAL maria d  martinetti COL name_chars VAL m a r i a   d     m a r t i n e t t i	COL name VAL maria martinetti COL name_chars VAL m a r i a   m a r t i n e t t i	1
COL name VAL maria j  martinetti COL name_chars VAL m a r i a   j     m a r t i n e t t i	COL name VAL maria martinetti COL name_chars VAL m a r i a   m a r t i n e t t i	1
COL name VAL henry b. loos COL name_chars VAL h e n r y   b .   l o o s	COL name VAL henry loos COL name_chars VAL h e n r y   l o o s	1
COL name VAL javier t  esparza COL name_chars VAL j a v i e r   t     e s p a r z a	COL name VAL javier esparza COL name_chars VAL j a v i e r   e s p a r z a	1
COL name VAL javier r  esparza COL name_chars VAL j a v i e r   r     e s p a r z a	COL name VAL javier esparza COL name_chars VAL j a v i e r   e s p a r z a	1
COL name VAL jorge j. garcía COL name_chars VAL j o r g e   j .   g a r c í a	COL name VAL jorge garcía COL name_chars VAL j o r g e   g a r c í a	1
COL name VAL jorge r. garcía COL name_chars VAL j o r g e   r .   g a r c í a	COL name VAL jorge garcía COL name_chars VAL j o r g e   g a r c í a	1
COL name VAL hans j  aune COL name_chars VAL h a n s   j     a u n e	COL name VAL hans aune COL name_chars VAL h a n s   a u n e	1
COL name VAL aurelio e  archinti COL name_chars VAL a u r e l i o   e     a r c h i n t i	COL name VAL aurelio archinti COL name_chars VAL a u r e l i o   a r c h i n t i	1
COL name VAL albert i  sambi lokonga COL name_chars VAL a l b e r t   i     s a m b i   l o k o n g a	COL name VAL albert sambi lokonga COL name_chars VAL a l b e r t   s a m b i   l o k o n g a	1
COL name VAL jean-claude t. clari COL name_chars VAL j e a n - c l a u d e   t .   c l a r i	COL name VAL jean-claude clari COL name_chars VAL j e a n - c l a u d e   c l a r i	1
COL name VAL delia t  valeri COL name_chars VAL d e l i a   t     v a l e r i	COL name VAL delia valeri COL name_chars VAL d e l i a   v a l e r i	1
COL name VAL delia s  valeri COL name_chars VAL d e l i a   s     v a l e r i	COL name VAL delia valeri COL name_chars VAL d e l i a   v a l e r i	1
COL name VAL delia p  valeri COL name_chars VAL d e l i a   p     v a l e r i	COL name VAL delia valeri COL name_chars VAL d e l i a   v a l e r i	1
COL name VAL maria k  echezarreta COL name_chars VAL m a r i a   k     e c h e z a r r e t a	COL name VAL maria echezarreta COL name_chars VAL m a r i a   e c h e z a r r e t a	1
COL name VAL maria l  echezarreta COL name_chars VAL m a r i a   l     e c h e z a r r e t a	COL name VAL maria echezarreta COL name_chars VAL m a r i a   e c h e z a r r e t a	1
COL name VAL ivan h  galar COL name_chars VAL i v a n   h     g a l a r	COL name VAL ivan galar COL name_chars VAL i v a n   g a l a r	1
COL name VAL ivan c. galar COL name_chars VAL i v a n   c .   g a l a r	COL name VAL ivan galar COL name_chars VAL i v a n   g a l a r	1
COL name VAL pat m  le paulmier COL name_chars VAL p a t   m     l e   p a u l m i e r	COL name VAL pat le paulmier COL name_chars VAL p a t   l e   p a u l m i e r	1
COL name VAL pat f  le paulmier COL name_chars VAL p a t   f     l e   p a u l m i e r	COL name VAL pat le paulmier COL name_chars VAL p a t   l e   p a u l m i e r	1
COL name VAL marcel a  flückiger COL name_chars VAL m a r c e l   a     f l ü c k i g e r	COL name VAL marcel flückiger COL name_chars VAL m a r c e l   f l ü c k i g e r	1
COL name VAL heinz c  lüdi COL name_chars VAL h e i n z   c     l ü d i	COL name VAL heinz lüdi COL name_chars VAL h e i n z   l ü d i	1
COL name VAL chris b  christenson COL name_chars VAL c h r i s   b     c h r i s t e n s o n	COL name VAL chris christenson COL name_chars VAL c h r i s   c h r i s t e n s o n	1
COL name VAL marguerite a  sechehaye COL name_chars VAL m a r g u e r i t e   a     s e c h e h a y e	COL name VAL marguerite sechehaye COL name_chars VAL m a r g u e r i t e   s e c h e h a y e	1
COL name VAL marguerite m. sechehaye COL name_chars VAL m a r g u e r i t e   m .   s e c h e h a y e	COL name VAL marguerite sechehaye COL name_chars VAL m a r g u e r i t e   s e c h e h a y e	1
COL name VAL marguerite m  sechehaye COL name_chars VAL m a r g u e r i t e   m     s e c h e h a y e	COL name VAL marguerite sechehaye COL name_chars VAL m a r g u e r i t e   s e c h e h a y e	1
COL name VAL rené j. gillard COL name_chars VAL r e n é   j .   g i l l a r d	COL name VAL rené gillard COL name_chars VAL r e n é   g i l l a r d	1
COL name VAL domenico w  pozzoni COL name_chars VAL d o m e n i c o   w     p o z z o n i	COL name VAL domenico pozzoni COL name_chars VAL d o m e n i c o   p o z z o n i	1
COL name VAL jostein m  gundersen COL name_chars VAL j o s t e i n   m     g u n d e r s e n	COL name VAL jostein gundersen COL name_chars VAL j o s t e i n   g u n d e r s e n	1
COL name VAL miriam h  pucci COL name_chars VAL m i r i a m   h     p u c c i	COL name VAL miriam pucci COL name_chars VAL m i r i a m   p u c c i	1
COL name VAL michele d. rossi COL name_chars VAL m i c h e l e   d .   r o s s i	COL name VAL michele rossi COL name_chars VAL m i c h e l e   r o s s i	1
COL name VAL jeroen z  van den broeck COL name_chars VAL j e r o e n   z     v a n   d e n   b r o e c k	COL name VAL jeroen van den broeck COL name_chars VAL j e r o e n   v a n   d e n   b r o e c k	1
COL name VAL markus r  wüst COL name_chars VAL m a r k u s   r     w ü s t	COL name VAL markus wüst COL name_chars VAL m a r k u s   w ü s t	1
COL name VAL stefano d. merlino COL name_chars VAL s t e f a n o   d .   m e r l i n o	COL name VAL stefano merlino COL name_chars VAL s t e f a n o   m e r l i n o	1
COL name VAL stefano e. merlino COL name_chars VAL s t e f a n o   e .   m e r l i n o	COL name VAL stefano merlino COL name_chars VAL s t e f a n o   m e r l i n o	1
COL name VAL stefano k  merlino COL name_chars VAL s t e f a n o   k     m e r l i n o	COL name VAL stefano merlino COL name_chars VAL s t e f a n o   m e r l i n o	1
COL name VAL mickaël a  tırpan COL name_chars VAL m i c k a ë l   a     t ı r p a n	COL name VAL mickaël tırpan COL name_chars VAL m i c k a ë l   t ı r p a n	1
COL name VAL mickaël e  tırpan COL name_chars VAL m i c k a ë l   e     t ı r p a n	COL name VAL mickaël tırpan COL name_chars VAL m i c k a ë l   t ı r p a n	1
COL name VAL maría i. barja COL name_chars VAL m a r í a   i .   b a r j a	COL name VAL maría barja COL name_chars VAL m a r í a   b a r j a	1
COL name VAL maría c. romay COL name_chars VAL m a r í a   c .   r o m a y	COL name VAL maría romay COL name_chars VAL m a r í a   r o m a y	1
COL name VAL josé manuel e. gutiérrez COL name_chars VAL j o s é   m a n u e l   e .   g u t i é r r e z	COL name VAL josé manuel gutiérrez COL name_chars VAL j o s é   m a n u e l   g u t i é r r e z	1
COL name VAL josé manuel k. gutiérrez COL name_chars VAL j o s é   m a n u e l   k .   g u t i é r r e z	COL name VAL josé manuel gutiérrez COL name_chars VAL j o s é   m a n u e l   g u t i é r r e z	1
COL name VAL isabel p. rodríguez COL name_chars VAL i s a b e l   p .   r o d r í g u e z	COL name VAL isabel rodríguez COL name_chars VAL i s a b e l   r o d r í g u e z	1
COL name VAL henry c. vollmer COL name_chars VAL h e n r y   c .   v o l l m e r	COL name VAL henry vollmer COL name_chars VAL h e n r y   v o l l m e r	1
COL name VAL john t  schutz COL name_chars VAL j o h n   t     s c h u t z	COL name VAL john schutz COL name_chars VAL j o h n   s c h u t z	1
COL name VAL cristina w. barja COL name_chars VAL c r i s t i n a   w .   b a r j a	COL name VAL cristina barja COL name_chars VAL c r i s t i n a   b a r j a	1
COL name VAL cristina d. romay COL name_chars VAL c r i s t i n a   d .   r o m a y	COL name VAL cristina romay COL name_chars VAL c r i s t i n a   r o m a y	1
COL name VAL pasqualina l  sarro COL name_chars VAL p a s q u a l i n a   l     s a r r o	COL name VAL pasqualina sarro COL name_chars VAL p a s q u a l i n a   s a r r o	1
COL name VAL pasqualina j. sarro COL name_chars VAL p a s q u a l i n a   j .   s a r r o	COL name VAL pasqualina sarro COL name_chars VAL p a s q u a l i n a   s a r r o	1
COL name VAL pasqualina a. sarro COL name_chars VAL p a s q u a l i n a   a .   s a r r o	COL name VAL pasqualina sarro COL name_chars VAL p a s q u a l i n a   s a r r o	1
COL name VAL pasqualina e  sarro COL name_chars VAL p a s q u a l i n a   e     s a r r o	COL name VAL pasqualina sarro COL name_chars VAL p a s q u a l i n a   s a r r o	1
COL name VAL johan h. bollen COL name_chars VAL j o h a n   h .   b o l l e n	COL name VAL johan bollen COL name_chars VAL j o h a n   b o l l e n	1
COL name VAL johan m  bollen COL name_chars VAL j o h a n   m     b o l l e n	COL name VAL johan bollen COL name_chars VAL j o h a n   b o l l e n	1
COL name VAL johan j. bollen COL name_chars VAL j o h a n   j .   b o l l e n	COL name VAL johan bollen COL name_chars VAL j o h a n   b o l l e n	1
COL name VAL johan d. bollen COL name_chars VAL j o h a n   d .   b o l l e n	COL name VAL johan bollen COL name_chars VAL j o h a n   b o l l e n	1
COL name VAL johan j. bollen COL name_chars VAL j o h a n   j .   b o l l e n	COL name VAL johan bollen COL name_chars VAL j o h a n   b o l l e n	1
COL name VAL johan p. bollen COL name_chars VAL j o h a n   p .   b o l l e n	COL name VAL johan bollen COL name_chars VAL j o h a n   b o l l e n	1
COL name VAL john a. granrud COL name_chars VAL j o h n   a .   g r a n r u d	COL name VAL john granrud COL name_chars VAL j o h n   g r a n r u d	1
COL name VAL john m. granrud COL name_chars VAL j o h n   m .   g r a n r u d	COL name VAL john granrud COL name_chars VAL j o h n   g r a n r u d	1
COL name VAL gabriele c  gresta COL name_chars VAL g a b r i e l e   c     g r e s t a	COL name VAL gabriele gresta COL name_chars VAL g a b r i e l e   g r e s t a	1
COL name VAL gabriele c. gresta COL name_chars VAL g a b r i e l e   c .   g r e s t a	COL name VAL gabriele gresta COL name_chars VAL g a b r i e l e   g r e s t a	1
COL name VAL manuel e. martos COL name_chars VAL m a n u e l   e .   m a r t o s	COL name VAL manuel martos COL name_chars VAL m a n u e l   m a r t o s	1
COL name VAL manuel s. parra COL name_chars VAL m a n u e l   s .   p a r r a	COL name VAL manuel parra COL name_chars VAL m a n u e l   p a r r a	1
COL name VAL nilde j  baracchi COL name_chars VAL n i l d e   j     b a r a c c h i	COL name VAL nilde baracchi COL name_chars VAL n i l d e   b a r a c c h i	1
COL name VAL frantz v  hofmann COL name_chars VAL f r a n t z   v     h o f m a n n	COL name VAL frantz hofmann COL name_chars VAL f r a n t z   h o f m a n n	1
COL name VAL lorena r. villa COL name_chars VAL l o r e n a   r .   v i l l a	COL name VAL lorena villa COL name_chars VAL l o r e n a   v i l l a	1
COL name VAL andré l  verdeil COL name_chars VAL a n d r é   l     v e r d e i l	COL name VAL andré verdeil COL name_chars VAL a n d r é   v e r d e i l	1
COL name VAL markus g. nüssli COL name_chars VAL m a r k u s   g .   n ü s s l i	COL name VAL markus nüssli COL name_chars VAL m a r k u s   n ü s s l i	1
COL name VAL tom c. pietermaat COL name_chars VAL t o m   c .   p i e t e r m a a t	COL name VAL tom pietermaat COL name_chars VAL t o m   p i e t e r m a a t	1
COL name VAL giovanni y. bianchi COL name_chars VAL g i o v a n n i   y .   b i a n c h i	COL name VAL giovanni bianchi COL name_chars VAL g i o v a n n i   b i a n c h i	1
COL name VAL rudolf m  keller COL name_chars VAL r u d o l f   m     k e l l e r	COL name VAL rudolf keller COL name_chars VAL r u d o l f   k e l l e r	1
COL name VAL f. f  froment COL name_chars VAL f .   f     f r o m e n t	COL name VAL f. froment COL name_chars VAL f .   f r o m e n t	1
COL name VAL gilbert b  froment COL name_chars VAL g i l b e r t   b     f r o m e n t	COL name VAL gilbert froment COL name_chars VAL g i l b e r t   f r o m e n t	1
COL name VAL f. m  froment COL name_chars VAL f .   m     f r o m e n t	COL name VAL f. froment COL name_chars VAL f .   f r o m e n t	1
COL name VAL gilbert d  froment COL name_chars VAL g i l b e r t   d     f r o m e n t	COL name VAL gilbert froment COL name_chars VAL g i l b e r t   f r o m e n t	1
COL name VAL jean i. neuhaus COL name_chars VAL j e a n   i .   n e u h a u s	COL name VAL jean neuhaus COL name_chars VAL j e a n   n e u h a u s	1
COL name VAL carolina r  wolters COL name_chars VAL c a r o l i n a   r     w o l t e r s	COL name VAL carolina wolters COL name_chars VAL c a r o l i n a   w o l t e r s	1
COL name VAL álvaro c  herreros COL name_chars VAL á l v a r o   c     h e r r e r o s	COL name VAL álvaro herreros COL name_chars VAL á l v a r o   h e r r e r o s	1
COL name VAL álvaro k. herreros COL name_chars VAL á l v a r o   k .   h e r r e r o s	COL name VAL álvaro herreros COL name_chars VAL á l v a r o   h e r r e r o s	1
COL name VAL julián m  martínez COL name_chars VAL j u l i á n   m     m a r t í n e z	COL name VAL julián martínez COL name_chars VAL j u l i á n   m a r t í n e z	1
COL name VAL roberto m. encinas COL name_chars VAL r o b e r t o   m .   e n c i n a s	COL name VAL roberto encinas COL name_chars VAL r o b e r t o   e n c i n a s	1
COL name VAL ruedi l  keller COL name_chars VAL r u e d i   l     k e l l e r	COL name VAL ruedi keller COL name_chars VAL r u e d i   k e l l e r	1
COL name VAL chris s. van puyvelde COL name_chars VAL c h r i s   s .   v a n   p u y v e l d e	COL name VAL chris van puyvelde COL name_chars VAL c h r i s   v a n   p u y v e l d e	1
COL name VAL bernhard s. müller COL name_chars VAL b e r n h a r d   s .   m ü l l e r	COL name VAL bernhard müller COL name_chars VAL b e r n h a r d   m ü l l e r	1
COL name VAL miguel ángel t. rubio COL name_chars VAL m i g u e l   á n g e l   t .   r u b i o	COL name VAL miguel ángel rubio COL name_chars VAL m i g u e l   á n g e l   r u b i o	1
COL name VAL modesto j. romero COL name_chars VAL m o d e s t o   j .   r o m e r o	COL name VAL modesto romero COL name_chars VAL m o d e s t o   r o m e r o	1
COL name VAL chloé c. van de velde COL name_chars VAL c h l o é   c .   v a n   d e   v e l d e	COL name VAL chloé van de velde COL name_chars VAL c h l o é   v a n   d e   v e l d e	1
COL name VAL chloé d  van de velde COL name_chars VAL c h l o é   d     v a n   d e   v e l d e	COL name VAL chloé van de velde COL name_chars VAL c h l o é   v a n   d e   v e l d e	1
COL name VAL chloé j  van de velde COL name_chars VAL c h l o é   j     v a n   d e   v e l d e	COL name VAL chloé van de velde COL name_chars VAL c h l o é   v a n   d e   v e l d e	1
COL name VAL joana a. garcía COL name_chars VAL j o a n a   a .   g a r c í a	COL name VAL joana garcía COL name_chars VAL j o a n a   g a r c í a	1
COL name VAL david p. campos COL name_chars VAL d a v i d   p .   c a m p o s	COL name VAL david campos COL name_chars VAL d a v i d   c a m p o s	1
COL name VAL zeno a. moser COL name_chars VAL z e n o   a .   m o s e r	COL name VAL zeno moser COL name_chars VAL z e n o   m o s e r	1
COL name VAL dominic r  pozzoni COL name_chars VAL d o m i n i c   r     p o z z o n i	COL name VAL dominic pozzoni COL name_chars VAL d o m i n i c   p o z z o n i	1
COL name VAL domingo r  campos COL name_chars VAL d o m i n g o   r     c a m p o s	COL name VAL domingo campos COL name_chars VAL d o m i n g o   c a m p o s	1
COL name VAL jørn r  stubberud COL name_chars VAL j ø r n   r     s t u b b e r u d	COL name VAL jørn stubberud COL name_chars VAL j ø r n   s t u b b e r u d	1
COL name VAL jürg f  wegelin COL name_chars VAL j ü r g   f     w e g e l i n	COL name VAL jürg wegelin COL name_chars VAL j ü r g   w e g e l i n	1
COL name VAL willy t  schäfer COL name_chars VAL w i l l y   t     s c h ä f e r	COL name VAL willy schäfer COL name_chars VAL w i l l y   s c h ä f e r	1
COL name VAL filippo s  rusuti COL name_chars VAL f i l i p p o   s     r u s u t i	COL name VAL filippo rusuti COL name_chars VAL f i l i p p o   r u s u t i	1
COL name VAL filippo a. rusuti COL name_chars VAL f i l i p p o   a .   r u s u t i	COL name VAL filippo rusuti COL name_chars VAL f i l i p p o   r u s u t i	1
COL name VAL filippo m  rusuti COL name_chars VAL f i l i p p o   m     r u s u t i	COL name VAL filippo rusuti COL name_chars VAL f i l i p p o   r u s u t i	1
COL name VAL filippo v  rusuti COL name_chars VAL f i l i p p o   v     r u s u t i	COL name VAL filippo rusuti COL name_chars VAL f i l i p p o   r u s u t i	1
COL name VAL filippo j. rusuti COL name_chars VAL f i l i p p o   j .   r u s u t i	COL name VAL filippo rusuti COL name_chars VAL f i l i p p o   r u s u t i	1
COL name VAL filippo p. rusuti COL name_chars VAL f i l i p p o   p .   r u s u t i	COL name VAL filippo rusuti COL name_chars VAL f i l i p p o   r u s u t i	1
COL name VAL filippo a  rusuti COL name_chars VAL f i l i p p o   a     r u s u t i	COL name VAL filippo rusuti COL name_chars VAL f i l i p p o   r u s u t i	1
COL name VAL belisario y. acquaviva COL name_chars VAL b e l i s a r i o   y .   a c q u a v i v a	COL name VAL belisario acquaviva COL name_chars VAL b e l i s a r i o   a c q u a v i v a	1
COL name VAL antonio a  gandini COL name_chars VAL a n t o n i o   a     g a n d i n i	COL name VAL antonio gandini COL name_chars VAL a n t o n i o   g a n d i n i	1
COL name VAL paolo t  roero COL name_chars VAL p a o l o   t     r o e r o	COL name VAL paolo roero COL name_chars VAL p a o l o   r o e r o	1
COL name VAL vincenzo h. roero COL name_chars VAL v i n c e n z o   h .   r o e r o	COL name VAL vincenzo roero COL name_chars VAL v i n c e n z o   r o e r o	1
COL name VAL riccardo t. grassetti COL name_chars VAL r i c c a r d o   t .   g r a s s e t t i	COL name VAL riccardo grassetti COL name_chars VAL r i c c a r d o   g r a s s e t t i	1
COL name VAL fritz f  schäublin COL name_chars VAL f r i t z   f     s c h ä u b l i n	COL name VAL fritz schäublin COL name_chars VAL f r i t z   s c h ä u b l i n	1
COL name VAL walter w  dürst COL name_chars VAL w a l t e r   w     d ü r s t	COL name VAL walter dürst COL name_chars VAL w a l t e r   d ü r s t	1
COL name VAL üli a  hofmann COL name_chars VAL ü l i   a     h o f m a n n	COL name VAL üli hofmann COL name_chars VAL ü l i   h o f m a n n	1
COL name VAL henry l. negretti COL name_chars VAL h e n r y   l .   n e g r e t t i	COL name VAL henry negretti COL name_chars VAL h e n r y   n e g r e t t i	1
COL name VAL henry t. negretti COL name_chars VAL h e n r y   t .   n e g r e t t i	COL name VAL henry negretti COL name_chars VAL h e n r y   n e g r e t t i	1
COL name VAL henry m  negretti COL name_chars VAL h e n r y   m     n e g r e t t i	COL name VAL henry negretti COL name_chars VAL h e n r y   n e g r e t t i	1
COL name VAL celestino c  pancheri COL name_chars VAL c e l e s t i n o   c     p a n c h e r i	COL name VAL celestino pancheri COL name_chars VAL c e l e s t i n o   p a n c h e r i	1
COL name VAL rené p  deck COL name_chars VAL r e n é   p     d e c k	COL name VAL rené deck COL name_chars VAL r e n é   d e c k	1
COL name VAL rené j  bader COL name_chars VAL r e n é   j     b a d e r	COL name VAL rené bader COL name_chars VAL r e n é   b a d e r	1
COL name VAL alessandro s. benassi COL name_chars VAL a l e s s a n d r o   s .   b e n a s s i	COL name VAL alessandro benassi COL name_chars VAL a l e s s a n d r o   b e n a s s i	1
COL name VAL alessandro k. benassi COL name_chars VAL a l e s s a n d r o   k .   b e n a s s i	COL name VAL alessandro benassi COL name_chars VAL a l e s s a n d r o   b e n a s s i	1
COL name VAL francesco m. barbieri COL name_chars VAL f r a n c e s c o   m .   b a r b i e r i	COL name VAL francesco barbieri COL name_chars VAL f r a n c e s c o   b a r b i e r i	1
COL name VAL francesco m  barbieri COL name_chars VAL f r a n c e s c o   m     b a r b i e r i	COL name VAL francesco barbieri COL name_chars VAL f r a n c e s c o   b a r b i e r i	1
COL name VAL francesco c. barbieri COL name_chars VAL f r a n c e s c o   c .   b a r b i e r i	COL name VAL francesco barbieri COL name_chars VAL f r a n c e s c o   b a r b i e r i	1
COL name VAL francesco r. barbieri COL name_chars VAL f r a n c e s c o   r .   b a r b i e r i	COL name VAL francesco barbieri COL name_chars VAL f r a n c e s c o   b a r b i e r i	1
COL name VAL francesco y. barbieri COL name_chars VAL f r a n c e s c o   y .   b a r b i e r i	COL name VAL francesco barbieri COL name_chars VAL f r a n c e s c o   b a r b i e r i	1
COL name VAL francesco m  barbieri COL name_chars VAL f r a n c e s c o   m     b a r b i e r i	COL name VAL francesco barbieri COL name_chars VAL f r a n c e s c o   b a r b i e r i	1
COL name VAL francesco a. barbieri COL name_chars VAL f r a n c e s c o   a .   b a r b i e r i	COL name VAL francesco barbieri COL name_chars VAL f r a n c e s c o   b a r b i e r i	1
COL name VAL edwin f. bryant COL name_chars VAL e d w i n   f .   b r y a n t	COL name VAL edwin bryant COL name_chars VAL e d w i n   b r y a n t	1
COL name VAL edwin b. bryant COL name_chars VAL e d w i n   b .   b r y a n t	COL name VAL edwin bryant COL name_chars VAL e d w i n   b r y a n t	1
COL name VAL edwin c  bryant COL name_chars VAL e d w i n   c     b r y a n t	COL name VAL edwin bryant COL name_chars VAL e d w i n   b r y a n t	1
COL name VAL marius d  larsen COL name_chars VAL m a r i u s   d     l a r s e n	COL name VAL marius larsen COL name_chars VAL m a r i u s   l a r s e n	1
COL name VAL kristoffer h. klaesson COL name_chars VAL k r i s t o f f e r   h .   k l a e s s o n	COL name VAL kristoffer klaesson COL name_chars VAL k r i s t o f f e r   k l a e s s o n	1
COL name VAL catherine r. verleysen COL name_chars VAL c a t h e r i n e   r .   v e r l e y s e n	COL name VAL catherine verleysen COL name_chars VAL c a t h e r i n e   v e r l e y s e n	1
COL name VAL alfredo m. fioravanti COL name_chars VAL a l f r e d o   m .   f i o r a v a n t i	COL name VAL alfredo fioravanti COL name_chars VAL a l f r e d o   f i o r a v a n t i	1
COL name VAL andreas s. ton COL name_chars VAL a n d r e a s   s .   t o n	COL name VAL andreas ton COL name_chars VAL a n d r e a s   t o n	1
COL name VAL ronald s  de sousa COL name_chars VAL r o n a l d   s     d e   s o u s a	COL name VAL ronald de sousa COL name_chars VAL r o n a l d   d e   s o u s a	1
COL name VAL felix g  myhre COL name_chars VAL f e l i x   g     m y h r e	COL name VAL felix myhre COL name_chars VAL f e l i x   m y h r e	1
COL name VAL therese m. åsland COL name_chars VAL t h e r e s e   m .   å s l a n d	COL name VAL therese åsland COL name_chars VAL t h e r e s e   å s l a n d	1
COL name VAL jésus t. barreda COL name_chars VAL j é s u s   t .   b a r r e d a	COL name VAL jésus barreda COL name_chars VAL j é s u s   b a r r e d a	1
COL name VAL jésus p. barreda COL name_chars VAL j é s u s   p .   b a r r e d a	COL name VAL jésus barreda COL name_chars VAL j é s u s   b a r r e d a	1
COL name VAL yossi c  hadar COL name_chars VAL y o s s i   c     h a d a r	COL name VAL yossi hadar COL name_chars VAL y o s s i   h a d a r	1
COL name VAL andy j  ton COL name_chars VAL a n d y   j     t o n	COL name VAL andy ton COL name_chars VAL a n d y   t o n	1
COL name VAL maria t  barreda COL name_chars VAL m a r i a   t     b a r r e d a	COL name VAL maria barreda COL name_chars VAL m a r i a   b a r r e d a	1
COL name VAL maria h. barreda COL name_chars VAL m a r i a   h .   b a r r e d a	COL name VAL maria barreda COL name_chars VAL m a r i a   b a r r e d a	1
COL name VAL karl k. kälin COL name_chars VAL k a r l   k .   k ä l i n	COL name VAL karl kälin COL name_chars VAL k a r l   k ä l i n	1
COL name VAL patrick m. bühlmann COL name_chars VAL p a t r i c k   m .   b ü h l m a n n	COL name VAL patrick bühlmann COL name_chars VAL p a t r i c k   b ü h l m a n n	1
COL name VAL manuel j. fernández COL name_chars VAL m a n u e l   j .   f e r n á n d e z	COL name VAL manuel fernández COL name_chars VAL m a n u e l   f e r n á n d e z	1
COL name VAL tomás h  fernández COL name_chars VAL t o m á s   h     f e r n á n d e z	COL name VAL tomás fernández COL name_chars VAL t o m á s   f e r n á n d e z	1
COL name VAL élisabeth h  duparc COL name_chars VAL é l i s a b e t h   h     d u p a r c	COL name VAL élisabeth duparc COL name_chars VAL é l i s a b e t h   d u p a r c	1
COL name VAL justin t. vulliamy COL name_chars VAL j u s t i n   t .   v u l l i a m y	COL name VAL justin vulliamy COL name_chars VAL j u s t i n   v u l l i a m y	1
COL name VAL bettina m. kühn COL name_chars VAL b e t t i n a   m .   k ü h n	COL name VAL bettina kühn COL name_chars VAL b e t t i n a   k ü h n	1
COL name VAL lars j  schjetne COL name_chars VAL l a r s   j     s c h j e t n e	COL name VAL lars schjetne COL name_chars VAL l a r s   s c h j e t n e	1
COL name VAL lars d  schjetne COL name_chars VAL l a r s   d     s c h j e t n e	COL name VAL lars schjetne COL name_chars VAL l a r s   s c h j e t n e	1
COL name VAL lars l. schjetne COL name_chars VAL l a r s   l .   s c h j e t n e	COL name VAL lars schjetne COL name_chars VAL l a r s   s c h j e t n e	1
COL name VAL jakob s. tromsdal COL name_chars VAL j a k o b   s .   t r o m s d a l	COL name VAL jakob tromsdal COL name_chars VAL j a k o b   t r o m s d a l	1
COL name VAL jakob d  tromsdal COL name_chars VAL j a k o b   d     t r o m s d a l	COL name VAL jakob tromsdal COL name_chars VAL j a k o b   t r o m s d a l	1
COL name VAL rikke j. nygard COL name_chars VAL r i k k e   j .   n y g a r d	COL name VAL rikke nygard COL name_chars VAL r i k k e   n y g a r d	1
COL name VAL rikke j  bogetveit COL name_chars VAL r i k k e   j     b o g e t v e i t	COL name VAL rikke bogetveit COL name_chars VAL r i k k e   b o g e t v e i t	1
COL name VAL gabrielle f. lie COL name_chars VAL g a b r i e l l e   f .   l i e	COL name VAL gabrielle lie COL name_chars VAL g a b r i e l l e   l i e	1
COL name VAL gabrielle g  lie COL name_chars VAL g a b r i e l l e   g     l i e	COL name VAL gabrielle lie COL name_chars VAL g a b r i e l l e   l i e	1
COL name VAL mia m. huse COL name_chars VAL m i a   m .   h u s e	COL name VAL mia huse COL name_chars VAL m i a   h u s e	1
COL name VAL guido u  pizarro COL name_chars VAL g u i d o   u     p i z a r r o	COL name VAL guido pizarro COL name_chars VAL g u i d o   p i z a r r o	1
COL name VAL alexandre h. crépet COL name_chars VAL a l e x a n d r e   h .   c r é p e t	COL name VAL alexandre crépet COL name_chars VAL a l e x a n d r e   c r é p e t	1
COL name VAL michelangelo s  di pietro COL name_chars VAL m i c h e l a n g e l o   s     d i   p i e t r o	COL name VAL michelangelo di pietro COL name_chars VAL m i c h e l a n g e l o   d i   p i e t r o	1
COL name VAL michelangelo j  di pietro COL name_chars VAL m i c h e l a n g e l o   j     d i   p i e t r o	COL name VAL michelangelo di pietro COL name_chars VAL m i c h e l a n g e l o   d i   p i e t r o	1
COL name VAL michelangelo m. di pietro COL name_chars VAL m i c h e l a n g e l o   m .   d i   p i e t r o	COL name VAL michelangelo di pietro COL name_chars VAL m i c h e l a n g e l o   d i   p i e t r o	1
COL name VAL michelangelo c. di pietro COL name_chars VAL m i c h e l a n g e l o   c .   d i   p i e t r o	COL name VAL michelangelo di pietro COL name_chars VAL m i c h e l a n g e l o   d i   p i e t r o	1
COL name VAL pietro l  adami COL name_chars VAL p i e t r o   l     a d a m i	COL name VAL pietro adami COL name_chars VAL p i e t r o   a d a m i	1
COL name VAL diego j. da silva COL name_chars VAL d i e g o   j .   d a   s i l v a	COL name VAL diego da silva COL name_chars VAL d i e g o   d a   s i l v a	1
COL name VAL diego l  giaretta COL name_chars VAL d i e g o   l     g i a r e t t a	COL name VAL diego giaretta COL name_chars VAL d i e g o   g i a r e t t a	1
COL name VAL erwan j. käser COL name_chars VAL e r w a n   j .   k ä s e r	COL name VAL erwan käser COL name_chars VAL e r w a n   k ä s e r	1
COL name VAL philippe w. fauchet COL name_chars VAL p h i l i p p e   w .   f a u c h e t	COL name VAL philippe fauchet COL name_chars VAL p h i l i p p e   f a u c h e t	1
COL name VAL max b. fauchet COL name_chars VAL m a x   b .   f a u c h e t	COL name VAL max fauchet COL name_chars VAL m a x   f a u c h e t	1
COL name VAL philippe m. fauchet COL name_chars VAL p h i l i p p e   m .   f a u c h e t	COL name VAL philippe fauchet COL name_chars VAL p h i l i p p e   f a u c h e t	1
COL name VAL max a  fauchet COL name_chars VAL m a x   a     f a u c h e t	COL name VAL max fauchet COL name_chars VAL m a x   f a u c h e t	1
COL name VAL kim-joy j. hewlett COL name_chars VAL k i m - j o y   j .   h e w l e t t	COL name VAL kim-joy hewlett COL name_chars VAL k i m - j o y   h e w l e t t	1
COL name VAL kim-joy j. hewlett COL name_chars VAL k i m - j o y   j .   h e w l e t t	COL name VAL kim-joy hewlett COL name_chars VAL k i m - j o y   h e w l e t t	1
COL name VAL klara a. sporsem COL name_chars VAL k l a r a   a .   s p o r s e m	COL name VAL klara sporsem COL name_chars VAL k l a r a   s p o r s e m	1
COL name VAL friedrich h  sustris COL name_chars VAL f r i e d r i c h   h     s u s t r i s	COL name VAL friedrich sustris COL name_chars VAL f r i e d r i c h   s u s t r i s	1
COL name VAL friedrich m. sustris COL name_chars VAL f r i e d r i c h   m .   s u s t r i s	COL name VAL friedrich sustris COL name_chars VAL f r i e d r i c h   s u s t r i s	1
COL name VAL friedrich c. sustris COL name_chars VAL f r i e d r i c h   c .   s u s t r i s	COL name VAL friedrich sustris COL name_chars VAL f r i e d r i c h   s u s t r i s	1
COL name VAL friedrich a  sustris COL name_chars VAL f r i e d r i c h   a     s u s t r i s	COL name VAL friedrich sustris COL name_chars VAL f r i e d r i c h   s u s t r i s	1
COL name VAL friedrich m. sustris COL name_chars VAL f r i e d r i c h   m .   s u s t r i s	COL name VAL friedrich sustris COL name_chars VAL f r i e d r i c h   s u s t r i s	1
COL name VAL friedrich m. sustris COL name_chars VAL f r i e d r i c h   m .   s u s t r i s	COL name VAL friedrich sustris COL name_chars VAL f r i e d r i c h   s u s t r i s	1
COL name VAL friedrich l. sustris COL name_chars VAL f r i e d r i c h   l .   s u s t r i s	COL name VAL friedrich sustris COL name_chars VAL f r i e d r i c h   s u s t r i s	1
COL name VAL friedrich j  sustris COL name_chars VAL f r i e d r i c h   j     s u s t r i s	COL name VAL friedrich sustris COL name_chars VAL f r i e d r i c h   s u s t r i s	1
COL name VAL friedrich t  sustris COL name_chars VAL f r i e d r i c h   t     s u s t r i s	COL name VAL friedrich sustris COL name_chars VAL f r i e d r i c h   s u s t r i s	1
COL name VAL friedrich c  sustris COL name_chars VAL f r i e d r i c h   c     s u s t r i s	COL name VAL friedrich sustris COL name_chars VAL f r i e d r i c h   s u s t r i s	1
COL name VAL friedrich i. sustris COL name_chars VAL f r i e d r i c h   i .   s u s t r i s	COL name VAL friedrich sustris COL name_chars VAL f r i e d r i c h   s u s t r i s	1
COL name VAL friedrich r. sustris COL name_chars VAL f r i e d r i c h   r .   s u s t r i s	COL name VAL friedrich sustris COL name_chars VAL f r i e d r i c h   s u s t r i s	1
COL name VAL friedrich r. sustris COL name_chars VAL f r i e d r i c h   r .   s u s t r i s	COL name VAL friedrich sustris COL name_chars VAL f r i e d r i c h   s u s t r i s	1
COL name VAL friedrich m. sustris COL name_chars VAL f r i e d r i c h   m .   s u s t r i s	COL name VAL friedrich sustris COL name_chars VAL f r i e d r i c h   s u s t r i s	1
COL name VAL friedrich w  sustris COL name_chars VAL f r i e d r i c h   w     s u s t r i s	COL name VAL friedrich sustris COL name_chars VAL f r i e d r i c h   s u s t r i s	1
COL name VAL friedrich l. sustris COL name_chars VAL f r i e d r i c h   l .   s u s t r i s	COL name VAL friedrich sustris COL name_chars VAL f r i e d r i c h   s u s t r i s	1
COL name VAL friedrich s. sustris COL name_chars VAL f r i e d r i c h   s .   s u s t r i s	COL name VAL friedrich sustris COL name_chars VAL f r i e d r i c h   s u s t r i s	1
COL name VAL friedrich p  sustris COL name_chars VAL f r i e d r i c h   p     s u s t r i s	COL name VAL friedrich sustris COL name_chars VAL f r i e d r i c h   s u s t r i s	1
COL name VAL friedrich m  sustris COL name_chars VAL f r i e d r i c h   m     s u s t r i s	COL name VAL friedrich sustris COL name_chars VAL f r i e d r i c h   s u s t r i s	1
COL name VAL friedrich d  sustris COL name_chars VAL f r i e d r i c h   d     s u s t r i s	COL name VAL friedrich sustris COL name_chars VAL f r i e d r i c h   s u s t r i s	1
COL name VAL peter a. müller COL name_chars VAL p e t e r   a .   m ü l l e r	COL name VAL peter müller COL name_chars VAL p e t e r   m ü l l e r	1
COL name VAL blanche b  charlet COL name_chars VAL b l a n c h e   b     c h a r l e t	COL name VAL blanche charlet COL name_chars VAL b l a n c h e   c h a r l e t	1
COL name VAL valentine e. charlet COL name_chars VAL v a l e n t i n e   e .   c h a r l e t	COL name VAL valentine charlet COL name_chars VAL v a l e n t i n e   c h a r l e t	1
COL name VAL carl c  colpaert COL name_chars VAL c a r l   c     c o l p a e r t	COL name VAL carl colpaert COL name_chars VAL c a r l   c o l p a e r t	1
COL name VAL tancrède r. dumas COL name_chars VAL t a n c r è d e   r .   d u m a s	COL name VAL tancrède dumas COL name_chars VAL t a n c r è d e   d u m a s	1
COL name VAL tancrède i. dumas COL name_chars VAL t a n c r è d e   i .   d u m a s	COL name VAL tancrède dumas COL name_chars VAL t a n c r è d e   d u m a s	1
COL name VAL tancrède b  dumas COL name_chars VAL t a n c r è d e   b     d u m a s	COL name VAL tancrède dumas COL name_chars VAL t a n c r è d e   d u m a s	1
COL name VAL tancrède e  dumas COL name_chars VAL t a n c r è d e   e     d u m a s	COL name VAL tancrède dumas COL name_chars VAL t a n c r è d e   d u m a s	1
COL name VAL tancrède s  dumas COL name_chars VAL t a n c r è d e   s     d u m a s	COL name VAL tancrède dumas COL name_chars VAL t a n c r è d e   d u m a s	1
COL name VAL nico m. brüngger COL name_chars VAL n i c o   m .   b r ü n g g e r	COL name VAL nico brüngger COL name_chars VAL n i c o   b r ü n g g e r	1
COL name VAL nico d. brüngger COL name_chars VAL n i c o   d .   b r ü n g g e r	COL name VAL nico brüngger COL name_chars VAL n i c o   b r ü n g g e r	1
COL name VAL gregory a  wüthrich COL name_chars VAL g r e g o r y   a     w ü t h r i c h	COL name VAL gregory wüthrich COL name_chars VAL g r e g o r y   w ü t h r i c h	1
COL name VAL arthur a. varney COL name_chars VAL a r t h u r   a .   v a r n e y	COL name VAL arthur varney COL name_chars VAL a r t h u r   v a r n e y	1
COL name VAL arthur l. varney COL name_chars VAL a r t h u r   l .   v a r n e y	COL name VAL arthur varney COL name_chars VAL a r t h u r   v a r n e y	1
COL name VAL gaetano h. mignani COL name_chars VAL g a e t a n o   h .   m i g n a n i	COL name VAL gaetano mignani COL name_chars VAL g a e t a n o   m i g n a n i	1
COL name VAL heidi a. ellingsen COL name_chars VAL h e i d i   a .   e l l i n g s e n	COL name VAL heidi ellingsen COL name_chars VAL h e i d i   e l l i n g s e n	1
COL name VAL frode o  hegland COL name_chars VAL f r o d e   o     h e g l a n d	COL name VAL frode hegland COL name_chars VAL f r o d e   h e g l a n d	1
COL name VAL alexander m  hegland COL name_chars VAL a l e x a n d e r   m     h e g l a n d	COL name VAL alexander hegland COL name_chars VAL a l e x a n d e r   h e g l a n d	1
COL name VAL agustín k. garcía COL name_chars VAL a g u s t í n   k .   g a r c í a	COL name VAL agustín garcía COL name_chars VAL a g u s t í n   g a r c í a	1
COL name VAL rodrigo l. de borja COL name_chars VAL r o d r i g o   l .   d e   b o r j a	COL name VAL rodrigo de borja COL name_chars VAL r o d r i g o   d e   b o r j a	1
COL name VAL julián p. lópez COL name_chars VAL j u l i á n   p .   l ó p e z	COL name VAL julián lópez COL name_chars VAL j u l i á n   l ó p e z	1
COL name VAL julián m. lópez COL name_chars VAL j u l i á n   m .   l ó p e z	COL name VAL julián lópez COL name_chars VAL j u l i á n   l ó p e z	1
COL name VAL otto g  bühler COL name_chars VAL o t t o   g     b ü h l e r	COL name VAL otto bühler COL name_chars VAL o t t o   b ü h l e r	1
COL name VAL otto a  bühler COL name_chars VAL o t t o   a     b ü h l e r	COL name VAL otto bühler COL name_chars VAL o t t o   b ü h l e r	1
COL name VAL otto e  schläpfer COL name_chars VAL o t t o   e     s c h l ä p f e r	COL name VAL otto schläpfer COL name_chars VAL o t t o   s c h l ä p f e r	1
COL name VAL ralph d. rüegg COL name_chars VAL r a l p h   d .   r ü e g g	COL name VAL ralph rüegg COL name_chars VAL r a l p h   r ü e g g	1
COL name VAL andré p. niederhäuser COL name_chars VAL a n d r é   p .   n i e d e r h ä u s e r	COL name VAL andré niederhäuser COL name_chars VAL a n d r é   n i e d e r h ä u s e r	1
COL name VAL valentina j. bosetti COL name_chars VAL v a l e n t i n a   j .   b o s e t t i	COL name VAL valentina bosetti COL name_chars VAL v a l e n t i n a   b o s e t t i	1
COL name VAL umberto c  romano COL name_chars VAL u m b e r t o   c     r o m a n o	COL name VAL umberto romano COL name_chars VAL u m b e r t o   r o m a n o	1
COL name VAL leonarda r. casiraghi COL name_chars VAL l e o n a r d a   r .   c a s i r a g h i	COL name VAL leonarda casiraghi COL name_chars VAL l e o n a r d a   c a s i r a g h i	1
COL name VAL george d  molteno COL name_chars VAL g e o r g e   d     m o l t e n o	COL name VAL george molteno COL name_chars VAL g e o r g e   m o l t e n o	1
COL name VAL george d. molteno COL name_chars VAL g e o r g e   d .   m o l t e n o	COL name VAL george molteno COL name_chars VAL g e o r g e   m o l t e n o	1
COL name VAL gianfranco i  felli COL name_chars VAL g i a n f r a n c o   i     f e l l i	COL name VAL gianfranco felli COL name_chars VAL g i a n f r a n c o   f e l l i	1
COL name VAL eva l. rønning COL name_chars VAL e v a   l .   r ø n n i n g	COL name VAL eva rønning COL name_chars VAL e v a   r ø n n i n g	1
COL name VAL eva r. fodor COL name_chars VAL e v a   r .   f o d o r	COL name VAL eva fodor COL name_chars VAL e v a   f o d o r	1
COL name VAL gret g  mann COL name_chars VAL g r e t   g     m a n n	COL name VAL gret mann COL name_chars VAL g r e t   m a n n	1
COL name VAL gret g  moser COL name_chars VAL g r e t   g     m o s e r	COL name VAL gret moser COL name_chars VAL g r e t   m o s e r	1
COL name VAL jorunn b. buckley COL name_chars VAL j o r u n n   b .   b u c k l e y	COL name VAL jorunn buckley COL name_chars VAL j o r u n n   b u c k l e y	1
COL name VAL jorunn b. buckley COL name_chars VAL j o r u n n   b .   b u c k l e y	COL name VAL jorunn buckley COL name_chars VAL j o r u n n   b u c k l e y	1
COL name VAL jorunn j. buckley COL name_chars VAL j o r u n n   j .   b u c k l e y	COL name VAL jorunn buckley COL name_chars VAL j o r u n n   b u c k l e y	1
COL name VAL joan p  massagué COL name_chars VAL j o a n   p     m a s s a g u é	COL name VAL joan massagué COL name_chars VAL j o a n   m a s s a g u é	1
COL name VAL joan f. massagué COL name_chars VAL j o a n   f .   m a s s a g u é	COL name VAL joan massagué COL name_chars VAL j o a n   m a s s a g u é	1
COL name VAL joan r. massagué COL name_chars VAL j o a n   r .   m a s s a g u é	COL name VAL joan massagué COL name_chars VAL j o a n   m a s s a g u é	1
COL name VAL joan p. massagué COL name_chars VAL j o a n   p .   m a s s a g u é	COL name VAL joan massagué COL name_chars VAL j o a n   m a s s a g u é	1
COL name VAL david g. rodrigo COL name_chars VAL d a v i d   g .   r o d r i g o	COL name VAL david rodrigo COL name_chars VAL d a v i d   r o d r i g o	1
COL name VAL miguel ángel w. araújo iglesias COL name_chars VAL m i g u e l   á n g e l   w .   a r a ú j o   i g l e s i a s	COL name VAL miguel ángel araújo iglesias COL name_chars VAL m i g u e l   á n g e l   a r a ú j o   i g l e s i a s	1
COL name VAL josé manuel e. egea COL name_chars VAL j o s é   m a n u e l   e .   e g e a	COL name VAL josé manuel egea COL name_chars VAL j o s é   m a n u e l   e g e a	1
COL name VAL joaquín h  novoa COL name_chars VAL j o a q u í n   h     n o v o a	COL name VAL joaquín novoa COL name_chars VAL j o a q u í n   n o v o a	1
COL name VAL rodolphe f  cuendet COL name_chars VAL r o d o l p h e   f     c u e n d e t	COL name VAL rodolphe cuendet COL name_chars VAL r o d o l p h e   c u e n d e t	1
COL name VAL silvan t. büchli COL name_chars VAL s i l v a n   t .   b ü c h l i	COL name VAL silvan büchli COL name_chars VAL s i l v a n   b ü c h l i	1
COL name VAL henry a. müller COL name_chars VAL h e n r y   a .   m ü l l e r	COL name VAL henry müller COL name_chars VAL h e n r y   m ü l l e r	1
COL name VAL leo j. pescarolo COL name_chars VAL l e o   j .   p e s c a r o l o	COL name VAL leo pescarolo COL name_chars VAL l e o   p e s c a r o l o	1
COL name VAL dany c. da silva COL name_chars VAL d a n y   c .   d a   s i l v a	COL name VAL dany da silva COL name_chars VAL d a n y   d a   s i l v a	1
COL name VAL petra p. walczewski COL name_chars VAL p e t r a   p .   w a l c z e w s k i	COL name VAL petra walczewski COL name_chars VAL p e t r a   w a l c z e w s k i	1
COL name VAL marie d  aubert COL name_chars VAL m a r i e   d     a u b e r t	COL name VAL marie aubert COL name_chars VAL m a r i e   a u b e r t	1
COL name VAL mercia t. harrison COL name_chars VAL m e r c i a   t .   h a r r i s o n	COL name VAL mercia harrison COL name_chars VAL m e r c i a   h a r r i s o n	1
COL name VAL martin p. tschudy COL name_chars VAL m a r t i n   p .   t s c h u d y	COL name VAL martin tschudy COL name_chars VAL m a r t i n   t s c h u d y	1
COL name VAL martin m. tschudi COL name_chars VAL m a r t i n   m .   t s c h u d i	COL name VAL martin tschudi COL name_chars VAL m a r t i n   t s c h u d i	1
COL name VAL mercia b. tinker COL name_chars VAL m e r c i a   b .   t i n k e r	COL name VAL mercia tinker COL name_chars VAL m e r c i a   t i n k e r	1
COL name VAL josé l. santiago concha COL name_chars VAL j o s é   l .   s a n t i a g o   c o n c h a	COL name VAL josé santiago concha COL name_chars VAL j o s é   s a n t i a g o   c o n c h a	1
COL name VAL antonio s  jiménez COL name_chars VAL a n t o n i o   s     j i m é n e z	COL name VAL antonio jiménez COL name_chars VAL a n t o n i o   j i m é n e z	1
COL name VAL nathaniel g. andré COL name_chars VAL n a t h a n i e l   g .   a n d r é	COL name VAL nathaniel andré COL name_chars VAL n a t h a n i e l   a n d r é	1
COL name VAL carlos e  arroyo COL name_chars VAL c a r l o s   e     a r r o y o	COL name VAL carlos arroyo COL name_chars VAL c a r l o s   a r r o y o	1
COL name VAL adolfo h  prada COL name_chars VAL a d o l f o   h     p r a d a	COL name VAL adolfo prada COL name_chars VAL a d o l f o   p r a d a	1
COL name VAL julien v. livi COL name_chars VAL j u l i e n   v .   l i v i	COL name VAL julien livi COL name_chars VAL j u l i e n   l i v i	1
COL name VAL manfredi g. lefebvre COL name_chars VAL m a n f r e d i   g .   l e f e b v r e	COL name VAL manfredi lefebvre COL name_chars VAL m a n f r e d i   l e f e b v r e	1
COL name VAL manfredi b. lefebvre COL name_chars VAL m a n f r e d i   b .   l e f e b v r e	COL name VAL manfredi lefebvre COL name_chars VAL m a n f r e d i   l e f e b v r e	1
COL name VAL manfredi c  lefebvre COL name_chars VAL m a n f r e d i   c     l e f e b v r e	COL name VAL manfredi lefebvre COL name_chars VAL m a n f r e d i   l e f e b v r e	1
COL name VAL elsa esnoult de michael je taime j. horváth COL name_chars VAL e l s a   e s n o u l t   d e   m i c h a e l   j e   t a i m e   j .   h o r v á t h	COL name VAL elsa esnoult de michael je taime horváth COL name_chars VAL e l s a   e s n o u l t   d e   m i c h a e l   j e   t a i m e   h o r v á t h	1
COL name VAL elsa esnoult de michael je taime l. horváth COL name_chars VAL e l s a   e s n o u l t   d e   m i c h a e l   j e   t a i m e   l .   h o r v á t h	COL name VAL elsa esnoult de michael je taime horváth COL name_chars VAL e l s a   e s n o u l t   d e   m i c h a e l   j e   t a i m e   h o r v á t h	1
COL name VAL markus s  bösiger COL name_chars VAL m a r k u s   s     b ö s i g e r	COL name VAL markus bösiger COL name_chars VAL m a r k u s   b ö s i g e r	1
COL name VAL conrad s  buff COL name_chars VAL c o n r a d   s     b u f f	COL name VAL conrad buff COL name_chars VAL c o n r a d   b u f f	1
COL name VAL conrad j  buff COL name_chars VAL c o n r a d   j     b u f f	COL name VAL conrad buff COL name_chars VAL c o n r a d   b u f f	1
COL name VAL joão c  oliveira COL name_chars VAL j o ã o   c     o l i v e i r a	COL name VAL joão oliveira COL name_chars VAL j o ã o   o l i v e i r a	1
COL name VAL e. l. garcin COL name_chars VAL e .   l .   g a r c i n	COL name VAL e. garcin COL name_chars VAL e .   g a r c i n	1
COL name VAL e. f. garcin COL name_chars VAL e .   f .   g a r c i n	COL name VAL e. garcin COL name_chars VAL e .   g a r c i n	1
COL name VAL francine x. lacqua COL name_chars VAL f r a n c i n e   x .   l a c q u a	COL name VAL francine lacqua COL name_chars VAL f r a n c i n e   l a c q u a	1
COL name VAL kat a. arney COL name_chars VAL k a t   a .   a r n e y	COL name VAL kat arney COL name_chars VAL k a t   a r n e y	1
COL name VAL sarah l  suphellen COL name_chars VAL s a r a h   l     s u p h e l l e n	COL name VAL sarah suphellen COL name_chars VAL s a r a h   s u p h e l l e n	1
COL name VAL sarah k  suphellen COL name_chars VAL s a r a h   k     s u p h e l l e n	COL name VAL sarah suphellen COL name_chars VAL s a r a h   s u p h e l l e n	1
COL name VAL michael j. wollan COL name_chars VAL m i c h a e l   j .   w o l l a n	COL name VAL michael wollan COL name_chars VAL m i c h a e l   w o l l a n	1
COL name VAL lars e  olson COL name_chars VAL l a r s   e     o l s o n	COL name VAL lars olson COL name_chars VAL l a r s   o l s o n	1
COL name VAL jens ó. opsahl COL name_chars VAL j e n s   ó .   o p s a h l	COL name VAL jens opsahl COL name_chars VAL j e n s   o p s a h l	1
COL name VAL john n. oppegaard COL name_chars VAL j o h n   n .   o p p e g a a r d	COL name VAL john oppegaard COL name_chars VAL j o h n   o p p e g a a r d	1
COL name VAL auguste r. garcin COL name_chars VAL a u g u s t e   r .   g a r c i n	COL name VAL auguste garcin COL name_chars VAL a u g u s t e   g a r c i n	1
COL name VAL auguste o. garcin COL name_chars VAL a u g u s t e   o .   g a r c i n	COL name VAL auguste garcin COL name_chars VAL a u g u s t e   g a r c i n	1
COL name VAL josé á. espelius COL name_chars VAL j o s é   á .   e s p e l i u s	COL name VAL josé espelius COL name_chars VAL j o s é   e s p e l i u s	1
