COL name VAL ivar diego nørve COL name_chars VAL i v a r   d i e g o   n ø r v e	COL name VAL ivar nørve COL name_chars VAL i v a r   n ø r v e	1
COL name VAL tore kim-joy heyerdahl COL name_chars VAL t o r e   k i m - j o y   h e y e r d a h l	COL name VAL tore heyerdahl COL name_chars VAL t o r e   h e y e r d a h l	1
COL name VAL tore ruth heyerdahl COL name_chars VAL t o r e   r u t h   h e y e r d a h l	COL name VAL tore heyerdahl COL name_chars VAL t o r e   h e y e r d a h l	1
COL name VAL peter todd bredal COL name_chars VAL p e t e r   t o d d   b r e d a l	COL name VAL peter bredal COL name_chars VAL p e t e r   b r e d a l	1
COL name VAL ingeborg hugh finnsdóttir COL name_chars VAL i n g e b o r g   h u g h   f i n n s d ó t t i r	COL name VAL ingeborg finnsdóttir COL name_chars VAL i n g e b o r g   f i n n s d ó t t i r	1
COL name VAL ingeborg john finnsdóttir COL name_chars VAL i n g e b o r g   j o h n   f i n n s d ó t t i r	COL name VAL ingeborg finnsdóttir COL name_chars VAL i n g e b o r g   f i n n s d ó t t i r	1
COL name VAL ingeborg richard finnsdóttir COL name_chars VAL i n g e b o r g   r i c h a r d   f i n n s d ó t t i r	COL name VAL ingeborg finnsdóttir COL name_chars VAL i n g e b o r g   f i n n s d ó t t i r	1
COL name VAL ivar helge nordkild COL name_chars VAL i v a r   h e l g e   n o r d k i l d	COL name VAL ivar nordkild COL name_chars VAL i v a r   n o r d k i l d	1
COL name VAL andrew tom stoltenberg COL name_chars VAL a n d r e w   t o m   s t o l t e n b e r g	COL name VAL andrew stoltenberg COL name_chars VAL a n d r e w   s t o l t e n b e r g	1
COL name VAL andrew nova stoltenberg COL name_chars VAL a n d r e w   n o v a   s t o l t e n b e r g	COL name VAL andrew stoltenberg COL name_chars VAL a n d r e w   s t o l t e n b e r g	1
COL name VAL astrid david johannessen COL name_chars VAL a s t r i d   d a v i d   j o h a n n e s s e n	COL name VAL astrid johannessen COL name_chars VAL a s t r i d   j o h a n n e s s e n	1
COL name VAL vlasta evelyn vrána COL name_chars VAL v l a s t a   e v e l y n   v r á n a	COL name VAL vlasta vrána COL name_chars VAL v l a s t a   v r á n a	1
COL name VAL werner eugene christie COL name_chars VAL w e r n e r   e u g e n e   c h r i s t i e	COL name VAL werner christie COL name_chars VAL w e r n e r   c h r i s t i e	1
COL name VAL bjørn ruth heyerdahl COL name_chars VAL b j ø r n   r u t h   h e y e r d a h l	COL name VAL bjørn heyerdahl COL name_chars VAL b j ø r n   h e y e r d a h l	1
COL name VAL bjørn manuel heyerdahl COL name_chars VAL b j ø r n   m a n u e l   h e y e r d a h l	COL name VAL bjørn heyerdahl COL name_chars VAL b j ø r n   h e y e r d a h l	1
COL name VAL øystein frances halfdansson COL name_chars VAL ø y s t e i n   f r a n c e s   h a l f d a n s s o n	COL name VAL øystein halfdansson COL name_chars VAL ø y s t e i n   h a l f d a n s s o n	1
COL name VAL eystein chris halfdansson COL name_chars VAL e y s t e i n   c h r i s   h a l f d a n s s o n	COL name VAL eystein halfdansson COL name_chars VAL e y s t e i n   h a l f d a n s s o n	1
COL name VAL øystein heidi halfdansson COL name_chars VAL ø y s t e i n   h e i d i   h a l f d a n s s o n	COL name VAL øystein halfdansson COL name_chars VAL ø y s t e i n   h a l f d a n s s o n	1
COL name VAL eystein victoria halfdansson COL name_chars VAL e y s t e i n   v i c t o r i a   h a l f d a n s s o n	COL name VAL eystein halfdansson COL name_chars VAL e y s t e i n   h a l f d a n s s o n	1
COL name VAL øystein lee halfdansson COL name_chars VAL ø y s t e i n   l e e   h a l f d a n s s o n	COL name VAL øystein halfdansson COL name_chars VAL ø y s t e i n   h a l f d a n s s o n	1
COL name VAL eystein john halfdansson COL name_chars VAL e y s t e i n   j o h n   h a l f d a n s s o n	COL name VAL eystein halfdansson COL name_chars VAL e y s t e i n   h a l f d a n s s o n	1
COL name VAL arne amir hassan røed COL name_chars VAL a r n e   a m i r   h a s s a n   r ø e d	COL name VAL arne røed COL name_chars VAL a r n e   r ø e d	1
COL name VAL arne norman røed COL name_chars VAL a r n e   n o r m a n   r ø e d	COL name VAL arne røed COL name_chars VAL a r n e   r ø e d	1
COL name VAL arne joseph røed COL name_chars VAL a r n e   j o s e p h   r ø e d	COL name VAL arne røed COL name_chars VAL a r n e   r ø e d	1
COL name VAL camillo elan everardi COL name_chars VAL c a m i l l o   e l a n   e v e r a r d i	COL name VAL camillo everardi COL name_chars VAL c a m i l l o   e v e r a r d i	1
COL name VAL camille john everardi COL name_chars VAL c a m i l l e   j o h n   e v e r a r d i	COL name VAL camille everardi COL name_chars VAL c a m i l l e   e v e r a r d i	1
COL name VAL alexandra ali joner COL name_chars VAL a l e x a n d r a   a l i   j o n e r	COL name VAL alexandra joner COL name_chars VAL a l e x a n d r a   j o n e r	1
COL name VAL solfrid richard heier COL name_chars VAL s o l f r i d   r i c h a r d   h e i e r	COL name VAL solfrid heier COL name_chars VAL s o l f r i d   h e i e r	1
COL name VAL christophe cameron schatteman COL name_chars VAL c h r i s t o p h e   c a m e r o n   s c h a t t e m a n	COL name VAL christophe schatteman COL name_chars VAL c h r i s t o p h e   s c h a t t e m a n	1
COL name VAL erik clyde schjerven COL name_chars VAL e r i k   c l y d e   s c h j e r v e n	COL name VAL erik schjerven COL name_chars VAL e r i k   s c h j e r v e n	1
COL name VAL gard bradley eidsvold COL name_chars VAL g a r d   b r a d l e y   e i d s v o l d	COL name VAL gard eidsvold COL name_chars VAL g a r d   e i d s v o l d	1
COL name VAL bjørnstjerne andy eidsvold COL name_chars VAL b j ø r n s t j e r n e   a n d y   e i d s v o l d	COL name VAL bjørnstjerne eidsvold COL name_chars VAL b j ø r n s t j e r n e   e i d s v o l d	1
COL name VAL harry darold lien COL name_chars VAL h a r r y   d a r o l d   l i e n	COL name VAL harry lien COL name_chars VAL h a r r y   l i e n	1
COL name VAL olaf louise tryggvason COL name_chars VAL o l a f   l o u i s e   t r y g g v a s o n	COL name VAL olaf tryggvason COL name_chars VAL o l a f   t r y g g v a s o n	1
COL name VAL victor clayton verschueren COL name_chars VAL v i c t o r   c l a y t o n   v e r s c h u e r e n	COL name VAL victor verschueren COL name_chars VAL v i c t o r   v e r s c h u e r e n	1
COL name VAL paulette delia cooper COL name_chars VAL p a u l e t t e   d e l i a   c o o p e r	COL name VAL paulette cooper COL name_chars VAL p a u l e t t e   c o o p e r	1
COL name VAL august thomas olsen COL name_chars VAL a u g u s t   t h o m a s   o l s e n	COL name VAL august olsen COL name_chars VAL a u g u s t   o l s e n	1
COL name VAL cecilie blanca mosli COL name_chars VAL c e c i l i e   b l a n c a   m o s l i	COL name VAL cecilie mosli COL name_chars VAL c e c i l i e   m o s l i	1
COL name VAL cecilie michelle mosli COL name_chars VAL c e c i l i e   m i c h e l l e   m o s l i	COL name VAL cecilie mosli COL name_chars VAL c e c i l i e   m o s l i	1
COL name VAL sondre jesse tronstad COL name_chars VAL s o n d r e   j e s s e   t r o n s t a d	COL name VAL sondre tronstad COL name_chars VAL s o n d r e   t r o n s t a d	1
COL name VAL truls john korsæth COL name_chars VAL t r u l s   j o h n   k o r s æ t h	COL name VAL truls korsæth COL name_chars VAL t r u l s   k o r s æ t h	1
COL name VAL truls john korsæth COL name_chars VAL t r u l s   j o h n   k o r s æ t h	COL name VAL truls korsæth COL name_chars VAL t r u l s   k o r s æ t h	1
COL name VAL truls brantley korsæth COL name_chars VAL t r u l s   b r a n t l e y   k o r s æ t h	COL name VAL truls korsæth COL name_chars VAL t r u l s   k o r s æ t h	1
COL name VAL tone umberto lima COL name_chars VAL t o n e   u m b e r t o   l i m a	COL name VAL tone lima COL name_chars VAL t o n e   l i m a	1
COL name VAL ingrid albert wold COL name_chars VAL i n g r i d   a l b e r t   w o l d	COL name VAL ingrid wold COL name_chars VAL i n g r i d   w o l d	1
COL name VAL henning henry olsen COL name_chars VAL h e n n i n g   h e n r y   o l s e n	COL name VAL henning olsen COL name_chars VAL h e n n i n g   o l s e n	1
COL name VAL magnus petros eriksson COL name_chars VAL m a g n u s   p e t r o s   e r i k s s o n	COL name VAL magnus eriksson COL name_chars VAL m a g n u s   e r i k s s o n	1
COL name VAL maunu kyle eriksson COL name_chars VAL m a u n u   k y l e   e r i k s s o n	COL name VAL maunu eriksson COL name_chars VAL m a u n u   e r i k s s o n	1
COL name VAL magnus michael eriksson COL name_chars VAL m a g n u s   m i c h a e l   e r i k s s o n	COL name VAL magnus eriksson COL name_chars VAL m a g n u s   e r i k s s o n	1
COL name VAL maunu samuel eriksson COL name_chars VAL m a u n u   s a m u e l   e r i k s s o n	COL name VAL maunu eriksson COL name_chars VAL m a u n u   e r i k s s o n	1
COL name VAL øystein delia magnusson COL name_chars VAL ø y s t e i n   d e l i a   m a g n u s s o n	COL name VAL øystein magnusson COL name_chars VAL ø y s t e i n   m a g n u s s o n	1
COL name VAL eysteinn bates magnusson COL name_chars VAL e y s t e i n n   b a t e s   m a g n u s s o n	COL name VAL eysteinn magnusson COL name_chars VAL e y s t e i n n   m a g n u s s o n	1
COL name VAL sigurd thomas munn COL name_chars VAL s i g u r d   t h o m a s   m u n n	COL name VAL sigurd munn COL name_chars VAL s i g u r d   m u n n	1
COL name VAL sigurd william munn COL name_chars VAL s i g u r d   w i l l i a m   m u n n	COL name VAL sigurd munn COL name_chars VAL s i g u r d   m u n n	1
COL name VAL sigurd e. munn COL name_chars VAL s i g u r d   e .   m u n n	COL name VAL sigurd munn COL name_chars VAL s i g u r d   m u n n	1
COL name VAL gunnbjörn michael ulfsson COL name_chars VAL g u n n b j ö r n   m i c h a e l   u l f s s o n	COL name VAL gunnbjörn ulfsson COL name_chars VAL g u n n b j ö r n   u l f s s o n	1
COL name VAL stéphanie alyssa van vyve COL name_chars VAL s t é p h a n i e   a l y s s a   v a n   v y v e	COL name VAL stéphanie van vyve COL name_chars VAL s t é p h a n i e   v a n   v y v e	1
COL name VAL vivian joey miessen COL name_chars VAL v i v i a n   j o e y   m i e s s e n	COL name VAL vivian miessen COL name_chars VAL v i v i a n   m i e s s e n	1
COL name VAL arnt alvina grønbech COL name_chars VAL a r n t   a l v i n a   g r ø n b e c h	COL name VAL arnt grønbech COL name_chars VAL a r n t   g r ø n b e c h	1
COL name VAL jarl jorge goli COL name_chars VAL j a r l   j o r g e   g o l i	COL name VAL jarl goli COL name_chars VAL j a r l   g o l i	1
COL name VAL arnaud lily borchgrave COL name_chars VAL a r n a u d   l i l y   b o r c h g r a v e	COL name VAL arnaud borchgrave COL name_chars VAL a r n a u d   b o r c h g r a v e	1
COL name VAL arnoud john de meyer COL name_chars VAL a r n o u d   j o h n   d e   m e y e r	COL name VAL arnoud de meyer COL name_chars VAL a r n o u d   d e   m e y e r	1
COL name VAL albert alison blanc COL name_chars VAL a l b e r t   a l i s o n   b l a n c	COL name VAL albert blanc COL name_chars VAL a l b e r t   b l a n c	1
COL name VAL john kat robson COL name_chars VAL j o h n   k a t   r o b s o n	COL name VAL john robson COL name_chars VAL j o h n   r o b s o n	1
COL name VAL ivan edgeworth robson COL name_chars VAL i v a n   e d g e w o r t h   r o b s o n	COL name VAL ivan robson COL name_chars VAL i v a n   r o b s o n	1
COL name VAL john sarah robson COL name_chars VAL j o h n   s a r a h   r o b s o n	COL name VAL john robson COL name_chars VAL j o h n   r o b s o n	1
COL name VAL ivan elias robson COL name_chars VAL i v a n   e l i a s   r o b s o n	COL name VAL ivan robson COL name_chars VAL i v a n   r o b s o n	1
COL name VAL john janet robson COL name_chars VAL j o h n   j a n e t   r o b s o n	COL name VAL john robson COL name_chars VAL j o h n   r o b s o n	1
COL name VAL ivan bert robson COL name_chars VAL i v a n   b e r t   r o b s o n	COL name VAL ivan robson COL name_chars VAL i v a n   r o b s o n	1
COL name VAL lise patrick nøstvold COL name_chars VAL l i s e   p a t r i c k   n ø s t v o l d	COL name VAL lise nøstvold COL name_chars VAL l i s e   n ø s t v o l d	1
COL name VAL lise peter nøstvold COL name_chars VAL l i s e   p e t e r   n ø s t v o l d	COL name VAL lise nøstvold COL name_chars VAL l i s e   n ø s t v o l d	1
COL name VAL lise edgeworth nøstvold COL name_chars VAL l i s e   e d g e w o r t h   n ø s t v o l d	COL name VAL lise nøstvold COL name_chars VAL l i s e   n ø s t v o l d	1
COL name VAL kari arghavan grønsund COL name_chars VAL k a r i   a r g h a v a n   g r ø n s u n d	COL name VAL kari grønsund COL name_chars VAL k a r i   g r ø n s u n d	1
COL name VAL håkon louise ericsson COL name_chars VAL h å k o n   l o u i s e   e r i c s s o n	COL name VAL håkon ericsson COL name_chars VAL h å k o n   e r i c s s o n	1
COL name VAL eystein gül magnusson COL name_chars VAL e y s t e i n   g ü l   m a g n u s s o n	COL name VAL eystein magnusson COL name_chars VAL e y s t e i n   m a g n u s s o n	1
COL name VAL øivind chad blunck COL name_chars VAL ø i v i n d   c h a d   b l u n c k	COL name VAL øivind blunck COL name_chars VAL ø i v i n d   b l u n c k	1
COL name VAL magnus yani barfod COL name_chars VAL m a g n u s   y a n i   b a r f o d	COL name VAL magnus barfod COL name_chars VAL m a g n u s   b a r f o d	1
COL name VAL ragnhild tomás mikkelsen COL name_chars VAL r a g n h i l d   t o m á s   m i k k e l s e n	COL name VAL ragnhild mikkelsen COL name_chars VAL r a g n h i l d   m i k k e l s e n	1
COL name VAL helene amélie goudin COL name_chars VAL h e l e n e   a m é l i e   g o u d i n	COL name VAL helene goudin COL name_chars VAL h e l e n e   g o u d i n	1
COL name VAL claire david goudin COL name_chars VAL c l a i r e   d a v i d   g o u d i n	COL name VAL claire goudin COL name_chars VAL c l a i r e   g o u d i n	1
COL name VAL henry ruth van den bulcke COL name_chars VAL h e n r y   r u t h   v a n   d e n   b u l c k e	COL name VAL henry van den bulcke COL name_chars VAL h e n r y   v a n   d e n   b u l c k e	1
COL name VAL jozef maria roey COL name_chars VAL j o z e f   m a r i a   r o e y	COL name VAL jozef roey COL name_chars VAL j o z e f   r o e y	1
COL name VAL ernest hardy roey COL name_chars VAL e r n e s t   h a r d y   r o e y	COL name VAL ernest roey COL name_chars VAL e r n e s t   r o e y	1
COL name VAL jozef helena roey COL name_chars VAL j o z e f   h e l e n a   r o e y	COL name VAL jozef roey COL name_chars VAL j o z e f   r o e y	1
COL name VAL ernest terry roey COL name_chars VAL e r n e s t   t e r r y   r o e y	COL name VAL ernest roey COL name_chars VAL e r n e s t   r o e y	1
COL name VAL liv matthew løberg COL name_chars VAL l i v   m a t t h e w   l ø b e r g	COL name VAL liv løberg COL name_chars VAL l i v   l ø b e r g	1
COL name VAL liv tyler løberg COL name_chars VAL l i v   t y l e r   l ø b e r g	COL name VAL liv løberg COL name_chars VAL l i v   l ø b e r g	1
COL name VAL liv frank løberg COL name_chars VAL l i v   f r a n k   l ø b e r g	COL name VAL liv løberg COL name_chars VAL l i v   l ø b e r g	1
COL name VAL stian juan ringstad COL name_chars VAL s t i a n   j u a n   r i n g s t a d	COL name VAL stian ringstad COL name_chars VAL s t i a n   r i n g s t a d	1
COL name VAL ánde eva somby COL name_chars VAL á n d e   e v a   s o m b y	COL name VAL ánde somby COL name_chars VAL á n d e   s o m b y	1
COL name VAL a. maeva westgard COL name_chars VAL a .   m a e v a   w e s t g a r d	COL name VAL a. westgard COL name_chars VAL a .   w e s t g a r d	1
COL name VAL siri angélica nordby COL name_chars VAL s i r i   a n g é l i c a   n o r d b y	COL name VAL siri nordby COL name_chars VAL s i r i   n o r d b y	1
COL name VAL siri patrick nordby COL name_chars VAL s i r i   p a t r i c k   n o r d b y	COL name VAL siri nordby COL name_chars VAL s i r i   n o r d b y	1
COL name VAL ole rodolphe halvorsen COL name_chars VAL o l e   r o d o l p h e   h a l v o r s e n	COL name VAL ole halvorsen COL name_chars VAL o l e   h a l v o r s e n	1
COL name VAL yurii maurice luhovyj COL name_chars VAL y u r i i   m a u r i c e   l u h o v y j	COL name VAL yurii luhovyj COL name_chars VAL y u r i i   l u h o v y j	1
COL name VAL yurii jessamyn luhovyj COL name_chars VAL y u r i i   j e s s a m y n   l u h o v y j	COL name VAL yurii luhovyj COL name_chars VAL y u r i i   l u h o v y j	1
COL name VAL yurii robert luhovyj COL name_chars VAL y u r i i   r o b e r t   l u h o v y j	COL name VAL yurii luhovyj COL name_chars VAL y u r i i   l u h o v y j	1
COL name VAL henrik jairo bjørdal COL name_chars VAL h e n r i k   j a i r o   b j ø r d a l	COL name VAL henrik bjørdal COL name_chars VAL h e n r i k   b j ø r d a l	1
COL name VAL ole nicholas skjelbred-knutsen COL name_chars VAL o l e   n i c h o l a s   s k j e l b r e d - k n u t s e n	COL name VAL ole skjelbred-knutsen COL name_chars VAL o l e   s k j e l b r e d - k n u t s e n	1
COL name VAL henri ingrid van den bulcke COL name_chars VAL h e n r i   i n g r i d   v a n   d e n   b u l c k e	COL name VAL henri van den bulcke COL name_chars VAL h e n r i   v a n   d e n   b u l c k e	1
COL name VAL harald john paalgard COL name_chars VAL h a r a l d   j o h n   p a a l g a r d	COL name VAL harald paalgard COL name_chars VAL h a r a l d   p a a l g a r d	1
COL name VAL bente david nordby COL name_chars VAL b e n t e   d a v i d   n o r d b y	COL name VAL bente nordby COL name_chars VAL b e n t e   n o r d b y	1
COL name VAL titti maria maartmann COL name_chars VAL t i t t i   m a r i a   m a a r t m a n n	COL name VAL titti maartmann COL name_chars VAL t i t t i   m a a r t m a n n	1
COL name VAL engelbert david sterckx COL name_chars VAL e n g e l b e r t   d a v i d   s t e r c k x	COL name VAL engelbert sterckx COL name_chars VAL e n g e l b e r t   s t e r c k x	1
COL name VAL engelbert didier sterckx COL name_chars VAL e n g e l b e r t   d i d i e r   s t e r c k x	COL name VAL engelbert sterckx COL name_chars VAL e n g e l b e r t   s t e r c k x	1
COL name VAL kim douglas huybrechts COL name_chars VAL k i m   d o u g l a s   h u y b r e c h t s	COL name VAL kim huybrechts COL name_chars VAL k i m   h u y b r e c h t s	1
COL name VAL martin veronica torp COL name_chars VAL m a r t i n   v e r o n i c a   t o r p	COL name VAL martin torp COL name_chars VAL m a r t i n   t o r p	1
COL name VAL pierre friedrich lagrange COL name_chars VAL p i e r r e   f r i e d r i c h   l a g r a n g e	COL name VAL pierre lagrange COL name_chars VAL p i e r r e   l a g r a n g e	1
COL name VAL johan ahad schwartz COL name_chars VAL j o h a n   a h a d   s c h w a r t z	COL name VAL johan schwartz COL name_chars VAL j o h a n   s c h w a r t z	1
COL name VAL eline najat brustad COL name_chars VAL e l i n e   n a j a t   b r u s t a d	COL name VAL eline brustad COL name_chars VAL e l i n e   b r u s t a d	1
COL name VAL petter christopher strand COL name_chars VAL p e t t e r   c h r i s t o p h e r   s t r a n d	COL name VAL petter strand COL name_chars VAL p e t t e r   s t r a n d	1
COL name VAL aryan najat tari COL name_chars VAL a r y a n   n a j a t   t a r i	COL name VAL aryan tari COL name_chars VAL a r y a n   t a r i	1
COL name VAL carlos alexandra cañas COL name_chars VAL c a r l o s   a l e x a n d r a   c a ñ a s	COL name VAL carlos cañas COL name_chars VAL c a r l o s   c a ñ a s	1
COL name VAL guri paul schanke COL name_chars VAL g u r i   p a u l   s c h a n k e	COL name VAL guri schanke COL name_chars VAL g u r i   s c h a n k e	1
COL name VAL annika louis schanke COL name_chars VAL a n n i k a   l o u i s   s c h a n k e	COL name VAL annika schanke COL name_chars VAL a n n i k a   s c h a n k e	1
COL name VAL frøydis robert wærsted COL name_chars VAL f r ø y d i s   r o b e r t   w æ r s t e d	COL name VAL frøydis wærsted COL name_chars VAL f r ø y d i s   w æ r s t e d	1
COL name VAL frøydis francis wærsted COL name_chars VAL f r ø y d i s   f r a n c i s   w æ r s t e d	COL name VAL frøydis wærsted COL name_chars VAL f r ø y d i s   w æ r s t e d	1
COL name VAL frøydis william wærsted COL name_chars VAL f r ø y d i s   w i l l i a m   w æ r s t e d	COL name VAL frøydis wærsted COL name_chars VAL f r ø y d i s   w æ r s t e d	1
COL name VAL hugo robert munthe-kaas COL name_chars VAL h u g o   r o b e r t   m u n t h e - k a a s	COL name VAL hugo munthe-kaas COL name_chars VAL h u g o   m u n t h e - k a a s	1
COL name VAL kjetil janet try COL name_chars VAL k j e t i l   j a n e t   t r y	COL name VAL kjetil try COL name_chars VAL k j e t i l   t r y	1
COL name VAL amélie ibrahim rorty COL name_chars VAL a m é l i e   i b r a h i m   r o r t y	COL name VAL amélie rorty COL name_chars VAL a m é l i e   r o r t y	1
COL name VAL amélie darold rorty COL name_chars VAL a m é l i e   d a r o l d   r o r t y	COL name VAL amélie rorty COL name_chars VAL a m é l i e   r o r t y	1
COL name VAL arne mike eggum COL name_chars VAL a r n e   m i k e   e g g u m	COL name VAL arne eggum COL name_chars VAL a r n e   e g g u m	1
COL name VAL lage alan lund COL name_chars VAL l a g e   a l a n   l u n d	COL name VAL lage lund COL name_chars VAL l a g e   l u n d	1
COL name VAL alain matts dehaze COL name_chars VAL a l a i n   m a t t s   d e h a z e	COL name VAL alain dehaze COL name_chars VAL a l a i n   d e h a z e	1
COL name VAL francisco ignatius cereijo COL name_chars VAL f r a n c i s c o   i g n a t i u s   c e r e i j o	COL name VAL francisco cereijo COL name_chars VAL f r a n c i s c o   c e r e i j o	1
COL name VAL francisco simone cereijo COL name_chars VAL f r a n c i s c o   s i m o n e   c e r e i j o	COL name VAL francisco cereijo COL name_chars VAL f r a n c i s c o   c e r e i j o	1
COL name VAL joaquín burak cañas COL name_chars VAL j o a q u í n   b u r a k   c a ñ a s	COL name VAL joaquín cañas COL name_chars VAL j o a q u í n   c a ñ a s	1
COL name VAL marcel lynn fässler COL name_chars VAL m a r c e l   l y n n   f ä s s l e r	COL name VAL marcel fässler COL name_chars VAL m a r c e l   f ä s s l e r	1
COL name VAL daniel frida müller COL name_chars VAL d a n i e l   f r i d a   m ü l l e r	COL name VAL daniel müller COL name_chars VAL d a n i e l   m ü l l e r	1
COL name VAL ditlev anders vibe COL name_chars VAL d i t l e v   a n d e r s   v i b e	COL name VAL ditlev vibe COL name_chars VAL d i t l e v   v i b e	1
COL name VAL peder harry andersen COL name_chars VAL p e d e r   h a r r y   a n d e r s e n	COL name VAL peder andersen COL name_chars VAL p e d e r   a n d e r s e n	1
COL name VAL mina john holtmann COL name_chars VAL m i n a   j o h n   h o l t m a n n	COL name VAL mina holtmann COL name_chars VAL m i n a   h o l t m a n n	1
COL name VAL mina harrison holtmann COL name_chars VAL m i n a   h a r r i s o n   h o l t m a n n	COL name VAL mina holtmann COL name_chars VAL m i n a   h o l t m a n n	1
COL name VAL fredrik gad galta COL name_chars VAL f r e d r i k   g a d   g a l t a	COL name VAL fredrik galta COL name_chars VAL f r e d r i k   g a l t a	1
COL name VAL anke lilla vanhooren COL name_chars VAL a n k e   l i l l a   v a n h o o r e n	COL name VAL anke vanhooren COL name_chars VAL a n k e   v a n h o o r e n	1
COL name VAL antonio annika suñol COL name_chars VAL a n t o n i o   a n n i k a   s u ñ o l	COL name VAL antonio suñol COL name_chars VAL a n t o n i o   s u ñ o l	1
COL name VAL antonio noah suñol COL name_chars VAL a n t o n i o   n o a h   s u ñ o l	COL name VAL antonio suñol COL name_chars VAL a n t o n i o   s u ñ o l	1
COL name VAL antonio crystal suñol COL name_chars VAL a n t o n i o   c r y s t a l   s u ñ o l	COL name VAL antonio suñol COL name_chars VAL a n t o n i o   s u ñ o l	1
COL name VAL antonio ignacio suñol COL name_chars VAL a n t o n i o   i g n a c i o   s u ñ o l	COL name VAL antonio suñol COL name_chars VAL a n t o n i o   s u ñ o l	1
COL name VAL gustavo luigi fernández COL name_chars VAL g u s t a v o   l u i g i   f e r n á n d e z	COL name VAL gustavo fernández COL name_chars VAL g u s t a v o   f e r n á n d e z	1
COL name VAL valeria walter pacheco COL name_chars VAL v a l e r i a   w a l t e r   p a c h e c o	COL name VAL valeria pacheco COL name_chars VAL v a l e r i a   p a c h e c o	1
COL name VAL óscar christina vizcaíno COL name_chars VAL ó s c a r   c h r i s t i n a   v i z c a í n o	COL name VAL óscar vizcaíno COL name_chars VAL ó s c a r   v i z c a í n o	1
COL name VAL óscar stephen vizcaíno COL name_chars VAL ó s c a r   s t e p h e n   v i z c a í n o	COL name VAL óscar vizcaíno COL name_chars VAL ó s c a r   v i z c a í n o	1
COL name VAL óscar danielle vizcaíno COL name_chars VAL ó s c a r   d a n i e l l e   v i z c a í n o	COL name VAL óscar vizcaíno COL name_chars VAL ó s c a r   v i z c a í n o	1
COL name VAL óscar ray vizcaíno COL name_chars VAL ó s c a r   r a y   v i z c a í n o	COL name VAL óscar vizcaíno COL name_chars VAL ó s c a r   v i z c a í n o	1
COL name VAL óscar eugene vizcaíno COL name_chars VAL ó s c a r   e u g e n e   v i z c a í n o	COL name VAL óscar vizcaíno COL name_chars VAL ó s c a r   v i z c a í n o	1
COL name VAL valeria christopher antolino COL name_chars VAL v a l e r i a   c h r i s t o p h e r   a n t o l i n o	COL name VAL valeria antolino COL name_chars VAL v a l e r i a   a n t o l i n o	1
COL name VAL gustavo thomas huertas COL name_chars VAL g u s t a v o   t h o m a s   h u e r t a s	COL name VAL gustavo huertas COL name_chars VAL g u s t a v o   h u e r t a s	1
COL name VAL eysteinn tuğçe erlendsson COL name_chars VAL e y s t e i n n   t u ğ ç e   e r l e n d s s o n	COL name VAL eysteinn erlendsson COL name_chars VAL e y s t e i n n   e r l e n d s s o n	1
COL name VAL eysteinn krystyna erlendsson COL name_chars VAL e y s t e i n n   k r y s t y n a   e r l e n d s s o n	COL name VAL eysteinn erlendsson COL name_chars VAL e y s t e i n n   e r l e n d s s o n	1
COL name VAL eysteinn melissa erlendsson COL name_chars VAL e y s t e i n n   m e l i s s a   e r l e n d s s o n	COL name VAL eysteinn erlendsson COL name_chars VAL e y s t e i n n   e r l e n d s s o n	1
COL name VAL eysteinn moriah erlendsson COL name_chars VAL e y s t e i n n   m o r i a h   e r l e n d s s o n	COL name VAL eysteinn erlendsson COL name_chars VAL e y s t e i n n   e r l e n d s s o n	1
COL name VAL pål yasmine johannessen COL name_chars VAL p å l   y a s m i n e   j o h a n n e s s e n	COL name VAL pål johannessen COL name_chars VAL p å l   j o h a n n e s s e n	1
COL name VAL petter yehuda olsen COL name_chars VAL p e t t e r   y e h u d a   o l s e n	COL name VAL petter olsen COL name_chars VAL p e t t e r   o l s e n	1
COL name VAL yōhei stephen miyake COL name_chars VAL y ō h e i   s t e p h e n   m i y a k e	COL name VAL yōhei miyake COL name_chars VAL y ō h e i   m i y a k e	1
COL name VAL yōhei stanley miyake COL name_chars VAL y ō h e i   s t a n l e y   m i y a k e	COL name VAL yōhei miyake COL name_chars VAL y ō h e i   m i y a k e	1
COL name VAL akinsola robert akinyemi COL name_chars VAL a k i n s o l a   r o b e r t   a k i n y e m i	COL name VAL akinsola akinyemi COL name_chars VAL a k i n s o l a   a k i n y e m i	1
COL name VAL akinsola john akinyemi COL name_chars VAL a k i n s o l a   j o h n   a k i n y e m i	COL name VAL akinsola akinyemi COL name_chars VAL a k i n s o l a   a k i n y e m i	1
COL name VAL dilşad josé şimşek COL name_chars VAL d i l ş a d   j o s é   ş i m ş e k	COL name VAL dilşad şimşek COL name_chars VAL d i l ş a d   ş i m ş e k	1
COL name VAL renee karl ginsberg COL name_chars VAL r e n e e   k a r l   g i n s b e r g	COL name VAL renee ginsberg COL name_chars VAL r e n e e   g i n s b e r g	1
COL name VAL renee douglas rabinowitz COL name_chars VAL r e n e e   d o u g l a s   r a b i n o w i t z	COL name VAL renee rabinowitz COL name_chars VAL r e n e e   r a b i n o w i t z	1
COL name VAL umberto akinsola cordani COL name_chars VAL u m b e r t o   a k i n s o l a   c o r d a n i	COL name VAL umberto cordani COL name_chars VAL u m b e r t o   c o r d a n i	1
COL name VAL francisco francisco lucini COL name_chars VAL f r a n c i s c o   f r a n c i s c o   l u c i n i	COL name VAL francisco lucini COL name_chars VAL f r a n c i s c o   l u c i n i	1
COL name VAL francisco ali lucini COL name_chars VAL f r a n c i s c o   a l i   l u c i n i	COL name VAL francisco lucini COL name_chars VAL f r a n c i s c o   l u c i n i	1
COL name VAL juan len pulido COL name_chars VAL j u a n   l e n   p u l i d o	COL name VAL juan pulido COL name_chars VAL j u a n   p u l i d o	1
COL name VAL yolanda grant heras COL name_chars VAL y o l a n d a   g r a n t   h e r a s	COL name VAL yolanda heras COL name_chars VAL y o l a n d a   h e r a s	1
COL name VAL blanca alvina hualde COL name_chars VAL b l a n c a   a l v i n a   h u a l d e	COL name VAL blanca hualde COL name_chars VAL b l a n c a   h u a l d e	1
COL name VAL maria david suñol COL name_chars VAL m a r i a   d a v i d   s u ñ o l	COL name VAL maria suñol COL name_chars VAL m a r i a   s u ñ o l	1
COL name VAL maria ignác suñol COL name_chars VAL m a r i a   i g n á c   s u ñ o l	COL name VAL maria suñol COL name_chars VAL m a r i a   s u ñ o l	1
COL name VAL maria jakob suñol COL name_chars VAL m a r i a   j a k o b   s u ñ o l	COL name VAL maria suñol COL name_chars VAL m a r i a   s u ñ o l	1
COL name VAL maria bill suñol COL name_chars VAL m a r i a   b i l l   s u ñ o l	COL name VAL maria suñol COL name_chars VAL m a r i a   s u ñ o l	1
COL name VAL yossi reece peled COL name_chars VAL y o s s i   r e e c e   p e l e d	COL name VAL yossi peled COL name_chars VAL y o s s i   p e l e d	1
COL name VAL yossi dean peled COL name_chars VAL y o s s i   d e a n   p e l e d	COL name VAL yossi peled COL name_chars VAL y o s s i   p e l e d	1
COL name VAL alexis michael scholl COL name_chars VAL a l e x i s   m i c h a e l   s c h o l l	COL name VAL alexis scholl COL name_chars VAL a l e x i s   s c h o l l	1
COL name VAL andreas ivan hanche-olsen COL name_chars VAL a n d r e a s   i v a n   h a n c h e - o l s e n	COL name VAL andreas hanche-olsen COL name_chars VAL a n d r e a s   h a n c h e - o l s e n	1
COL name VAL vinny tom lauwers COL name_chars VAL v i n n y   t o m   l a u w e r s	COL name VAL vinny lauwers COL name_chars VAL v i n n y   l a u w e r s	1
COL name VAL alexis robert michael lefrançois COL name_chars VAL a l e x i s   r o b e r t   m i c h a e l   l e f r a n ç o i s	COL name VAL alexis lefrançois COL name_chars VAL a l e x i s   l e f r a n ç o i s	1
COL name VAL maría victoria pablo mateos COL name_chars VAL m a r í a   v i c t o r i a   p a b l o   m a t e o s	COL name VAL maría victoria mateos COL name_chars VAL m a r í a   v i c t o r i a   m a t e o s	1
COL name VAL maría victoria ruth mateos COL name_chars VAL m a r í a   v i c t o r i a   r u t h   m a t e o s	COL name VAL maría victoria mateos COL name_chars VAL m a r í a   v i c t o r i a   m a t e o s	1
COL name VAL delfina charles entrecanales COL name_chars VAL d e l f i n a   c h a r l e s   e n t r e c a n a l e s	COL name VAL delfina entrecanales COL name_chars VAL d e l f i n a   e n t r e c a n a l e s	1
COL name VAL delfina mary entrecanales COL name_chars VAL d e l f i n a   m a r y   e n t r e c a n a l e s	COL name VAL delfina entrecanales COL name_chars VAL d e l f i n a   e n t r e c a n a l e s	1
COL name VAL henrik james christiansen COL name_chars VAL h e n r i k   j a m e s   c h r i s t i a n s e n	COL name VAL henrik christiansen COL name_chars VAL h e n r i k   c h r i s t i a n s e n	1
COL name VAL henrik øystein christiansen COL name_chars VAL h e n r i k   ø y s t e i n   c h r i s t i a n s e n	COL name VAL henrik christiansen COL name_chars VAL h e n r i k   c h r i s t i a n s e n	1
COL name VAL jakob paul bagge COL name_chars VAL j a k o b   p a u l   b a g g e	COL name VAL jakob bagge COL name_chars VAL j a k o b   b a g g e	1
COL name VAL håvard john nybø COL name_chars VAL h å v a r d   j o h n   n y b ø	COL name VAL håvard nybø COL name_chars VAL h å v a r d   n y b ø	1
COL name VAL emil patrick filliol COL name_chars VAL e m i l   p a t r i c k   f i l l i o l	COL name VAL emil filliol COL name_chars VAL e m i l   f i l l i o l	1
COL name VAL erik stephen steen COL name_chars VAL e r i k   s t e p h e n   s t e e n	COL name VAL erik steen COL name_chars VAL e r i k   s t e e n	1
COL name VAL magnus vasily grødem COL name_chars VAL m a g n u s   v a s i l y   g r ø d e m	COL name VAL magnus grødem COL name_chars VAL m a g n u s   g r ø d e m	1
COL name VAL marcella arthur jackson COL name_chars VAL m a r c e l l a   a r t h u r   j a c k s o n	COL name VAL marcella jackson COL name_chars VAL m a r c e l l a   j a c k s o n	1
COL name VAL mary vivian jackson COL name_chars VAL m a r y   v i v i a n   j a c k s o n	COL name VAL mary jackson COL name_chars VAL m a r y   j a c k s o n	1
COL name VAL marcella eric jackson COL name_chars VAL m a r c e l l a   e r i c   j a c k s o n	COL name VAL marcella jackson COL name_chars VAL m a r c e l l a   j a c k s o n	1
COL name VAL mary friedrich jackson COL name_chars VAL m a r y   f r i e d r i c h   j a c k s o n	COL name VAL mary jackson COL name_chars VAL m a r y   j a c k s o n	1
COL name VAL pol lori lozano COL name_chars VAL p o l   l o r i   l o z a n o	COL name VAL pol lozano COL name_chars VAL p o l   l o z a n o	1
COL name VAL claudia albert cividino COL name_chars VAL c l a u d i a   a l b e r t   c i v i d i n o	COL name VAL claudia cividino COL name_chars VAL c l a u d i a   c i v i d i n o	1
COL name VAL claudia rené cividino COL name_chars VAL c l a u d i a   r e n é   c i v i d i n o	COL name VAL claudia cividino COL name_chars VAL c l a u d i a   c i v i d i n o	1
COL name VAL cristina didem montijano COL name_chars VAL c r i s t i n a   d i d e m   m o n t i j a n o	COL name VAL cristina montijano COL name_chars VAL c r i s t i n a   m o n t i j a n o	1
COL name VAL juan raissa jiménez COL name_chars VAL j u a n   r a i s s a   j i m é n e z	COL name VAL juan jiménez COL name_chars VAL j u a n   j i m é n e z	1
COL name VAL genaro gül gamboa COL name_chars VAL g e n a r o   g ü l   g a m b o a	COL name VAL genaro gamboa COL name_chars VAL g e n a r o   g a m b o a	1
COL name VAL gabriel michael jiménez COL name_chars VAL g a b r i e l   m i c h a e l   j i m é n e z	COL name VAL gabriel jiménez COL name_chars VAL g a b r i e l   j i m é n e z	1
COL name VAL erik douglas wollen COL name_chars VAL e r i k   d o u g l a s   w o l l e n	COL name VAL erik wollen COL name_chars VAL e r i k   w o l l e n	1
COL name VAL carolina fifi montijano COL name_chars VAL c a r o l i n a   f i f i   m o n t i j a n o	COL name VAL carolina montijano COL name_chars VAL c a r o l i n a   m o n t i j a n o	1
COL name VAL andré auristela christiansen COL name_chars VAL a n d r é   a u r i s t e l a   c h r i s t i a n s e n	COL name VAL andré christiansen COL name_chars VAL a n d r é   c h r i s t i a n s e n	1
COL name VAL andré john christiansen COL name_chars VAL a n d r é   j o h n   c h r i s t i a n s e n	COL name VAL andré christiansen COL name_chars VAL a n d r é   c h r i s t i a n s e n	1
COL name VAL sven david kristiansen COL name_chars VAL s v e n   d a v i d   k r i s t i a n s e n	COL name VAL sven kristiansen COL name_chars VAL s v e n   k r i s t i a n s e n	1
COL name VAL peter jon schärer COL name_chars VAL p e t e r   j o n   s c h ä r e r	COL name VAL peter schärer COL name_chars VAL p e t e r   s c h ä r e r	1
COL name VAL samy alan mmaee COL name_chars VAL s a m y   a l a n   m m a e e	COL name VAL samy mmaee COL name_chars VAL s a m y   m m a e e	1
COL name VAL morten maria solvik COL name_chars VAL m o r t e n   m a r i a   s o l v i k	COL name VAL morten solvik COL name_chars VAL m o r t e n   s o l v i k	1
COL name VAL morten barbara solvik COL name_chars VAL m o r t e n   b a r b a r a   s o l v i k	COL name VAL morten solvik COL name_chars VAL m o r t e n   s o l v i k	1
COL name VAL iselin kenneth solheim COL name_chars VAL i s e l i n   k e n n e t h   s o l h e i m	COL name VAL iselin solheim COL name_chars VAL i s e l i n   s o l h e i m	1
COL name VAL maria eli sarro COL name_chars VAL m a r i a   e l i   s a r r o	COL name VAL maria sarro COL name_chars VAL m a r i a   s a r r o	1
COL name VAL maria george sarro COL name_chars VAL m a r i a   g e o r g e   s a r r o	COL name VAL maria sarro COL name_chars VAL m a r i a   s a r r o	1
COL name VAL maria maria sarro COL name_chars VAL m a r i a   m a r i a   s a r r o	COL name VAL maria sarro COL name_chars VAL m a r i a   s a r r o	1
COL name VAL maria scott sarro COL name_chars VAL m a r i a   s c o t t   s a r r o	COL name VAL maria sarro COL name_chars VAL m a r i a   s a r r o	1
COL name VAL maria rebecca martinetti COL name_chars VAL m a r i a   r e b e c c a   m a r t i n e t t i	COL name VAL maria martinetti COL name_chars VAL m a r i a   m a r t i n e t t i	1
COL name VAL maria jeroen martinetti COL name_chars VAL m a r i a   j e r o e n   m a r t i n e t t i	COL name VAL maria martinetti COL name_chars VAL m a r i a   m a r t i n e t t i	1
COL name VAL maria megan martinetti COL name_chars VAL m a r i a   m e g a n   m a r t i n e t t i	COL name VAL maria martinetti COL name_chars VAL m a r i a   m a r t i n e t t i	1
COL name VAL henry david loos COL name_chars VAL h e n r y   d a v i d   l o o s	COL name VAL henry loos COL name_chars VAL h e n r y   l o o s	1
COL name VAL javier john esparza COL name_chars VAL j a v i e r   j o h n   e s p a r z a	COL name VAL javier esparza COL name_chars VAL j a v i e r   e s p a r z a	1
COL name VAL javier silvia esparza COL name_chars VAL j a v i e r   s i l v i a   e s p a r z a	COL name VAL javier esparza COL name_chars VAL j a v i e r   e s p a r z a	1
COL name VAL jorge blanche garcía COL name_chars VAL j o r g e   b l a n c h e   g a r c í a	COL name VAL jorge garcía COL name_chars VAL j o r g e   g a r c í a	1
COL name VAL jorge álvaro garcía COL name_chars VAL j o r g e   á l v a r o   g a r c í a	COL name VAL jorge garcía COL name_chars VAL j o r g e   g a r c í a	1
COL name VAL hans bates aune COL name_chars VAL h a n s   b a t e s   a u n e	COL name VAL hans aune COL name_chars VAL h a n s   a u n e	1
COL name VAL aurelio mario archinti COL name_chars VAL a u r e l i o   m a r i o   a r c h i n t i	COL name VAL aurelio archinti COL name_chars VAL a u r e l i o   a r c h i n t i	1
COL name VAL albert gabriella sambi lokonga COL name_chars VAL a l b e r t   g a b r i e l l a   s a m b i   l o k o n g a	COL name VAL albert sambi lokonga COL name_chars VAL a l b e r t   s a m b i   l o k o n g a	1
COL name VAL jean-claude maunu clari COL name_chars VAL j e a n - c l a u d e   m a u n u   c l a r i	COL name VAL jean-claude clari COL name_chars VAL j e a n - c l a u d e   c l a r i	1
COL name VAL delia sibel valeri COL name_chars VAL d e l i a   s i b e l   v a l e r i	COL name VAL delia valeri COL name_chars VAL d e l i a   v a l e r i	1
COL name VAL delia harris valeri COL name_chars VAL d e l i a   h a r r i s   v a l e r i	COL name VAL delia valeri COL name_chars VAL d e l i a   v a l e r i	1
COL name VAL delia nicholas valeri COL name_chars VAL d e l i a   n i c h o l a s   v a l e r i	COL name VAL delia valeri COL name_chars VAL d e l i a   v a l e r i	1
COL name VAL maria marcos echezarreta COL name_chars VAL m a r i a   m a r c o s   e c h e z a r r e t a	COL name VAL maria echezarreta COL name_chars VAL m a r i a   e c h e z a r r e t a	1
COL name VAL maria ricardo echezarreta COL name_chars VAL m a r i a   r i c a r d o   e c h e z a r r e t a	COL name VAL maria echezarreta COL name_chars VAL m a r i a   e c h e z a r r e t a	1
COL name VAL ivan carl galar COL name_chars VAL i v a n   c a r l   g a l a r	COL name VAL ivan galar COL name_chars VAL i v a n   g a l a r	1
COL name VAL ivan lon galar COL name_chars VAL i v a n   l o n   g a l a r	COL name VAL ivan galar COL name_chars VAL i v a n   g a l a r	1
COL name VAL pat paul le paulmier COL name_chars VAL p a t   p a u l   l e   p a u l m i e r	COL name VAL pat le paulmier COL name_chars VAL p a t   l e   p a u l m i e r	1
COL name VAL pat josé manuel le paulmier COL name_chars VAL p a t   j o s é   m a n u e l   l e   p a u l m i e r	COL name VAL pat le paulmier COL name_chars VAL p a t   l e   p a u l m i e r	1
COL name VAL marcel nils flückiger COL name_chars VAL m a r c e l   n i l s   f l ü c k i g e r	COL name VAL marcel flückiger COL name_chars VAL m a r c e l   f l ü c k i g e r	1
COL name VAL heinz hugh lüdi COL name_chars VAL h e i n z   h u g h   l ü d i	COL name VAL heinz lüdi COL name_chars VAL h e i n z   l ü d i	1
COL name VAL chris alvina christenson COL name_chars VAL c h r i s   a l v i n a   c h r i s t e n s o n	COL name VAL chris christenson COL name_chars VAL c h r i s   c h r i s t e n s o n	1
COL name VAL marguerite leroy sechehaye COL name_chars VAL m a r g u e r i t e   l e r o y   s e c h e h a y e	COL name VAL marguerite sechehaye COL name_chars VAL m a r g u e r i t e   s e c h e h a y e	1
COL name VAL marguerite pascal sechehaye COL name_chars VAL m a r g u e r i t e   p a s c a l   s e c h e h a y e	COL name VAL marguerite sechehaye COL name_chars VAL m a r g u e r i t e   s e c h e h a y e	1
COL name VAL marguerite mordechai sechehaye COL name_chars VAL m a r g u e r i t e   m o r d e c h a i   s e c h e h a y e	COL name VAL marguerite sechehaye COL name_chars VAL m a r g u e r i t e   s e c h e h a y e	1
COL name VAL rené michael gillard COL name_chars VAL r e n é   m i c h a e l   g i l l a r d	COL name VAL rené gillard COL name_chars VAL r e n é   g i l l a r d	1
COL name VAL domenico susan pozzoni COL name_chars VAL d o m e n i c o   s u s a n   p o z z o n i	COL name VAL domenico pozzoni COL name_chars VAL d o m e n i c o   p o z z o n i	1
COL name VAL jostein katia gundersen COL name_chars VAL j o s t e i n   k a t i a   g u n d e r s e n	COL name VAL jostein gundersen COL name_chars VAL j o s t e i n   g u n d e r s e n	1
COL name VAL miriam allie pucci COL name_chars VAL m i r i a m   a l l i e   p u c c i	COL name VAL miriam pucci COL name_chars VAL m i r i a m   p u c c i	1
COL name VAL michele elisabeth rossi COL name_chars VAL m i c h e l e   e l i s a b e t h   r o s s i	COL name VAL michele rossi COL name_chars VAL m i c h e l e   r o s s i	1
COL name VAL jeroen barbara van den broeck COL name_chars VAL j e r o e n   b a r b a r a   v a n   d e n   b r o e c k	COL name VAL jeroen van den broeck COL name_chars VAL j e r o e n   v a n   d e n   b r o e c k	1
COL name VAL markus edwin wüst COL name_chars VAL m a r k u s   e d w i n   w ü s t	COL name VAL markus wüst COL name_chars VAL m a r k u s   w ü s t	1
COL name VAL stefano jayda merlino COL name_chars VAL s t e f a n o   j a y d a   m e r l i n o	COL name VAL stefano merlino COL name_chars VAL s t e f a n o   m e r l i n o	1
COL name VAL stefano henrik merlino COL name_chars VAL s t e f a n o   h e n r i k   m e r l i n o	COL name VAL stefano merlino COL name_chars VAL s t e f a n o   m e r l i n o	1
COL name VAL stefano h. merlino COL name_chars VAL s t e f a n o   h .   m e r l i n o	COL name VAL stefano merlino COL name_chars VAL s t e f a n o   m e r l i n o	1
COL name VAL mickaël christophe tırpan COL name_chars VAL m i c k a ë l   c h r i s t o p h e   t ı r p a n	COL name VAL mickaël tırpan COL name_chars VAL m i c k a ë l   t ı r p a n	1
COL name VAL mickaël burhanettin tırpan COL name_chars VAL m i c k a ë l   b u r h a n e t t i n   t ı r p a n	COL name VAL mickaël tırpan COL name_chars VAL m i c k a ë l   t ı r p a n	1
COL name VAL maría isabel barja COL name_chars VAL m a r í a   i s a b e l   b a r j a	COL name VAL maría barja COL name_chars VAL m a r í a   b a r j a	1
COL name VAL maría winnifred romay COL name_chars VAL m a r í a   w i n n i f r e d   r o m a y	COL name VAL maría romay COL name_chars VAL m a r í a   r o m a y	1
COL name VAL josé manuel reza gutiérrez COL name_chars VAL j o s é   m a n u e l   r e z a   g u t i é r r e z	COL name VAL josé manuel gutiérrez COL name_chars VAL j o s é   m a n u e l   g u t i é r r e z	1
COL name VAL josé manuel haden gutiérrez COL name_chars VAL j o s é   m a n u e l   h a d e n   g u t i é r r e z	COL name VAL josé manuel gutiérrez COL name_chars VAL j o s é   m a n u e l   g u t i é r r e z	1
COL name VAL isabel eddie rodríguez COL name_chars VAL i s a b e l   e d d i e   r o d r í g u e z	COL name VAL isabel rodríguez COL name_chars VAL i s a b e l   r o d r í g u e z	1
COL name VAL henry yusuf vollmer COL name_chars VAL h e n r y   y u s u f   v o l l m e r	COL name VAL henry vollmer COL name_chars VAL h e n r y   v o l l m e r	1
COL name VAL john kimberly schutz COL name_chars VAL j o h n   k i m b e r l y   s c h u t z	COL name VAL john schutz COL name_chars VAL j o h n   s c h u t z	1
COL name VAL cristina lou barja COL name_chars VAL c r i s t i n a   l o u   b a r j a	COL name VAL cristina barja COL name_chars VAL c r i s t i n a   b a r j a	1
COL name VAL cristina dave romay COL name_chars VAL c r i s t i n a   d a v e   r o m a y	COL name VAL cristina romay COL name_chars VAL c r i s t i n a   r o m a y	1
COL name VAL pasqualina melissa sarro COL name_chars VAL p a s q u a l i n a   m e l i s s a   s a r r o	COL name VAL pasqualina sarro COL name_chars VAL p a s q u a l i n a   s a r r o	1
COL name VAL pasqualina müge sarro COL name_chars VAL p a s q u a l i n a   m ü g e   s a r r o	COL name VAL pasqualina sarro COL name_chars VAL p a s q u a l i n a   s a r r o	1
COL name VAL pasqualina onofrio sarro COL name_chars VAL p a s q u a l i n a   o n o f r i o   s a r r o	COL name VAL pasqualina sarro COL name_chars VAL p a s q u a l i n a   s a r r o	1
COL name VAL pasqualina emma sarro COL name_chars VAL p a s q u a l i n a   e m m a   s a r r o	COL name VAL pasqualina sarro COL name_chars VAL p a s q u a l i n a   s a r r o	1
COL name VAL johan saeed bollen COL name_chars VAL j o h a n   s a e e d   b o l l e n	COL name VAL johan bollen COL name_chars VAL j o h a n   b o l l e n	1
COL name VAL johan david bollen COL name_chars VAL j o h a n   d a v i d   b o l l e n	COL name VAL johan bollen COL name_chars VAL j o h a n   b o l l e n	1
COL name VAL johan gregory bollen COL name_chars VAL j o h a n   g r e g o r y   b o l l e n	COL name VAL johan bollen COL name_chars VAL j o h a n   b o l l e n	1
COL name VAL johan aminé bollen COL name_chars VAL j o h a n   a m i n é   b o l l e n	COL name VAL johan bollen COL name_chars VAL j o h a n   b o l l e n	1
COL name VAL johan lorena bollen COL name_chars VAL j o h a n   l o r e n a   b o l l e n	COL name VAL johan bollen COL name_chars VAL j o h a n   b o l l e n	1
COL name VAL johan alicia bollen COL name_chars VAL j o h a n   a l i c i a   b o l l e n	COL name VAL johan bollen COL name_chars VAL j o h a n   b o l l e n	1
COL name VAL john louis granrud COL name_chars VAL j o h n   l o u i s   g r a n r u d	COL name VAL john granrud COL name_chars VAL j o h n   g r a n r u d	1
COL name VAL john linda granrud COL name_chars VAL j o h n   l i n d a   g r a n r u d	COL name VAL john granrud COL name_chars VAL j o h n   g r a n r u d	1
COL name VAL gabriele grigori gresta COL name_chars VAL g a b r i e l e   g r i g o r i   g r e s t a	COL name VAL gabriele gresta COL name_chars VAL g a b r i e l e   g r e s t a	1
COL name VAL gabriele maria gresta COL name_chars VAL g a b r i e l e   m a r i a   g r e s t a	COL name VAL gabriele gresta COL name_chars VAL g a b r i e l e   g r e s t a	1
COL name VAL manuel daniel martos COL name_chars VAL m a n u e l   d a n i e l   m a r t o s	COL name VAL manuel martos COL name_chars VAL m a n u e l   m a r t o s	1
COL name VAL manuel müge parra COL name_chars VAL m a n u e l   m ü g e   p a r r a	COL name VAL manuel parra COL name_chars VAL m a n u e l   p a r r a	1
COL name VAL nilde richard baracchi COL name_chars VAL n i l d e   r i c h a r d   b a r a c c h i	COL name VAL nilde baracchi COL name_chars VAL n i l d e   b a r a c c h i	1
COL name VAL frantz peder hofmann COL name_chars VAL f r a n t z   p e d e r   h o f m a n n	COL name VAL frantz hofmann COL name_chars VAL f r a n t z   h o f m a n n	1
COL name VAL lorena mia villa COL name_chars VAL l o r e n a   m i a   v i l l a	COL name VAL lorena villa COL name_chars VAL l o r e n a   v i l l a	1
COL name VAL andré steve verdeil COL name_chars VAL a n d r é   s t e v e   v e r d e i l	COL name VAL andré verdeil COL name_chars VAL a n d r é   v e r d e i l	1
COL name VAL markus diego nüssli COL name_chars VAL m a r k u s   d i e g o   n ü s s l i	COL name VAL markus nüssli COL name_chars VAL m a r k u s   n ü s s l i	1
COL name VAL tom elsa esnoult de michael je taime pietermaat COL name_chars VAL t o m   e l s a   e s n o u l t   d e   m i c h a e l   j e   t a i m e   p i e t e r m a a t	COL name VAL tom pietermaat COL name_chars VAL t o m   p i e t e r m a a t	1
COL name VAL giovanni osmund bianchi COL name_chars VAL g i o v a n n i   o s m u n d   b i a n c h i	COL name VAL giovanni bianchi COL name_chars VAL g i o v a n n i   b i a n c h i	1
COL name VAL rudolf thomas keller COL name_chars VAL r u d o l f   t h o m a s   k e l l e r	COL name VAL rudolf keller COL name_chars VAL r u d o l f   k e l l e r	1
COL name VAL f. zaccaria froment COL name_chars VAL f .   z a c c a r i a   f r o m e n t	COL name VAL f. froment COL name_chars VAL f .   f r o m e n t	1
COL name VAL gilbert derick froment COL name_chars VAL g i l b e r t   d e r i c k   f r o m e n t	COL name VAL gilbert froment COL name_chars VAL g i l b e r t   f r o m e n t	1
COL name VAL f. karina froment COL name_chars VAL f .   k a r i n a   f r o m e n t	COL name VAL f. froment COL name_chars VAL f .   f r o m e n t	1
COL name VAL gilbert eric froment COL name_chars VAL g i l b e r t   e r i c   f r o m e n t	COL name VAL gilbert froment COL name_chars VAL g i l b e r t   f r o m e n t	1
COL name VAL jean tom neuhaus COL name_chars VAL j e a n   t o m   n e u h a u s	COL name VAL jean neuhaus COL name_chars VAL j e a n   n e u h a u s	1
COL name VAL carolina ahmed wolters COL name_chars VAL c a r o l i n a   a h m e d   w o l t e r s	COL name VAL carolina wolters COL name_chars VAL c a r o l i n a   w o l t e r s	1
COL name VAL álvaro liz herreros COL name_chars VAL á l v a r o   l i z   h e r r e r o s	COL name VAL álvaro herreros COL name_chars VAL á l v a r o   h e r r e r o s	1
COL name VAL álvaro menachem herreros COL name_chars VAL á l v a r o   m e n a c h e m   h e r r e r o s	COL name VAL álvaro herreros COL name_chars VAL á l v a r o   h e r r e r o s	1
COL name VAL julián adolfo martínez COL name_chars VAL j u l i á n   a d o l f o   m a r t í n e z	COL name VAL julián martínez COL name_chars VAL j u l i á n   m a r t í n e z	1
COL name VAL roberto louis encinas COL name_chars VAL r o b e r t o   l o u i s   e n c i n a s	COL name VAL roberto encinas COL name_chars VAL r o b e r t o   e n c i n a s	1
COL name VAL ruedi federico keller COL name_chars VAL r u e d i   f e d e r i c o   k e l l e r	COL name VAL ruedi keller COL name_chars VAL r u e d i   k e l l e r	1
COL name VAL chris jon van puyvelde COL name_chars VAL c h r i s   j o n   v a n   p u y v e l d e	COL name VAL chris van puyvelde COL name_chars VAL c h r i s   v a n   p u y v e l d e	1
COL name VAL bernhard blanche müller COL name_chars VAL b e r n h a r d   b l a n c h e   m ü l l e r	COL name VAL bernhard müller COL name_chars VAL b e r n h a r d   m ü l l e r	1
COL name VAL miguel ángel cornelia rubio COL name_chars VAL m i g u e l   á n g e l   c o r n e l i a   r u b i o	COL name VAL miguel ángel rubio COL name_chars VAL m i g u e l   á n g e l   r u b i o	1
COL name VAL modesto benedetto romero COL name_chars VAL m o d e s t o   b e n e d e t t o   r o m e r o	COL name VAL modesto romero COL name_chars VAL m o d e s t o   r o m e r o	1
COL name VAL chloé edmund van de velde COL name_chars VAL c h l o é   e d m u n d   v a n   d e   v e l d e	COL name VAL chloé van de velde COL name_chars VAL c h l o é   v a n   d e   v e l d e	1
COL name VAL chloé samuel van de velde COL name_chars VAL c h l o é   s a m u e l   v a n   d e   v e l d e	COL name VAL chloé van de velde COL name_chars VAL c h l o é   v a n   d e   v e l d e	1
COL name VAL chloé otto van de velde COL name_chars VAL c h l o é   o t t o   v a n   d e   v e l d e	COL name VAL chloé van de velde COL name_chars VAL c h l o é   v a n   d e   v e l d e	1
COL name VAL joana edmund garcía COL name_chars VAL j o a n a   e d m u n d   g a r c í a	COL name VAL joana garcía COL name_chars VAL j o a n a   g a r c í a	1
COL name VAL david armin campos COL name_chars VAL d a v i d   a r m i n   c a m p o s	COL name VAL david campos COL name_chars VAL d a v i d   c a m p o s	1
COL name VAL zeno louisa moser COL name_chars VAL z e n o   l o u i s a   m o s e r	COL name VAL zeno moser COL name_chars VAL z e n o   m o s e r	1
COL name VAL dominic ignace pozzoni COL name_chars VAL d o m i n i c   i g n a c e   p o z z o n i	COL name VAL dominic pozzoni COL name_chars VAL d o m i n i c   p o z z o n i	1
COL name VAL domingo micah campos COL name_chars VAL d o m i n g o   m i c a h   c a m p o s	COL name VAL domingo campos COL name_chars VAL d o m i n g o   c a m p o s	1
COL name VAL jørn tom stubberud COL name_chars VAL j ø r n   t o m   s t u b b e r u d	COL name VAL jørn stubberud COL name_chars VAL j ø r n   s t u b b e r u d	1
COL name VAL jürg christine wegelin COL name_chars VAL j ü r g   c h r i s t i n e   w e g e l i n	COL name VAL jürg wegelin COL name_chars VAL j ü r g   w e g e l i n	1
COL name VAL willy urbanus schäfer COL name_chars VAL w i l l y   u r b a n u s   s c h ä f e r	COL name VAL willy schäfer COL name_chars VAL w i l l y   s c h ä f e r	1
COL name VAL filippo aurora rusuti COL name_chars VAL f i l i p p o   a u r o r a   r u s u t i	COL name VAL filippo rusuti COL name_chars VAL f i l i p p o   r u s u t i	1
COL name VAL filippo julius rusuti COL name_chars VAL f i l i p p o   j u l i u s   r u s u t i	COL name VAL filippo rusuti COL name_chars VAL f i l i p p o   r u s u t i	1
COL name VAL filippo hannah rusuti COL name_chars VAL f i l i p p o   h a n n a h   r u s u t i	COL name VAL filippo rusuti COL name_chars VAL f i l i p p o   r u s u t i	1
COL name VAL filippo richard rusuti COL name_chars VAL f i l i p p o   r i c h a r d   r u s u t i	COL name VAL filippo rusuti COL name_chars VAL f i l i p p o   r u s u t i	1
COL name VAL filippo halime rusuti COL name_chars VAL f i l i p p o   h a l i m e   r u s u t i	COL name VAL filippo rusuti COL name_chars VAL f i l i p p o   r u s u t i	1
COL name VAL filippo shauna rusuti COL name_chars VAL f i l i p p o   s h a u n a   r u s u t i	COL name VAL filippo rusuti COL name_chars VAL f i l i p p o   r u s u t i	1
COL name VAL filippo elisabeth rusuti COL name_chars VAL f i l i p p o   e l i s a b e t h   r u s u t i	COL name VAL filippo rusuti COL name_chars VAL f i l i p p o   r u s u t i	1
COL name VAL belisario j. acquaviva COL name_chars VAL b e l i s a r i o   j .   a c q u a v i v a	COL name VAL belisario acquaviva COL name_chars VAL b e l i s a r i o   a c q u a v i v a	1
COL name VAL antonio marcia gandini COL name_chars VAL a n t o n i o   m a r c i a   g a n d i n i	COL name VAL antonio gandini COL name_chars VAL a n t o n i o   g a n d i n i	1
COL name VAL paolo deanne roero COL name_chars VAL p a o l o   d e a n n e   r o e r o	COL name VAL paolo roero COL name_chars VAL p a o l o   r o e r o	1
COL name VAL vincenzo richard roero COL name_chars VAL v i n c e n z o   r i c h a r d   r o e r o	COL name VAL vincenzo roero COL name_chars VAL v i n c e n z o   r o e r o	1
COL name VAL riccardo adam grassetti COL name_chars VAL r i c c a r d o   a d a m   g r a s s e t t i	COL name VAL riccardo grassetti COL name_chars VAL r i c c a r d o   g r a s s e t t i	1
COL name VAL fritz norman schäublin COL name_chars VAL f r i t z   n o r m a n   s c h ä u b l i n	COL name VAL fritz schäublin COL name_chars VAL f r i t z   s c h ä u b l i n	1
COL name VAL walter elan dürst COL name_chars VAL w a l t e r   e l a n   d ü r s t	COL name VAL walter dürst COL name_chars VAL w a l t e r   d ü r s t	1
COL name VAL üli limor hofmann COL name_chars VAL ü l i   l i m o r   h o f m a n n	COL name VAL üli hofmann COL name_chars VAL ü l i   h o f m a n n	1
COL name VAL henry jozef negretti COL name_chars VAL h e n r y   j o z e f   n e g r e t t i	COL name VAL henry negretti COL name_chars VAL h e n r y   n e g r e t t i	1
COL name VAL henry joan negretti COL name_chars VAL h e n r y   j o a n   n e g r e t t i	COL name VAL henry negretti COL name_chars VAL h e n r y   n e g r e t t i	1
COL name VAL henry juan negretti COL name_chars VAL h e n r y   j u a n   n e g r e t t i	COL name VAL henry negretti COL name_chars VAL h e n r y   n e g r e t t i	1
COL name VAL celestino susan pancheri COL name_chars VAL c e l e s t i n o   s u s a n   p a n c h e r i	COL name VAL celestino pancheri COL name_chars VAL c e l e s t i n o   p a n c h e r i	1
COL name VAL rené tancrède deck COL name_chars VAL r e n é   t a n c r è d e   d e c k	COL name VAL rené deck COL name_chars VAL r e n é   d e c k	1
COL name VAL rené joseph bader COL name_chars VAL r e n é   j o s e p h   b a d e r	COL name VAL rené bader COL name_chars VAL r e n é   b a d e r	1
COL name VAL alessandro ruth benassi COL name_chars VAL a l e s s a n d r o   r u t h   b e n a s s i	COL name VAL alessandro benassi COL name_chars VAL a l e s s a n d r o   b e n a s s i	1
COL name VAL alessandro james benassi COL name_chars VAL a l e s s a n d r o   j a m e s   b e n a s s i	COL name VAL alessandro benassi COL name_chars VAL a l e s s a n d r o   b e n a s s i	1
COL name VAL francesco antonio barbieri COL name_chars VAL f r a n c e s c o   a n t o n i o   b a r b i e r i	COL name VAL francesco barbieri COL name_chars VAL f r a n c e s c o   b a r b i e r i	1
COL name VAL francesco james barbieri COL name_chars VAL f r a n c e s c o   j a m e s   b a r b i e r i	COL name VAL francesco barbieri COL name_chars VAL f r a n c e s c o   b a r b i e r i	1
COL name VAL francesco wiliam barbieri COL name_chars VAL f r a n c e s c o   w i l i a m   b a r b i e r i	COL name VAL francesco barbieri COL name_chars VAL f r a n c e s c o   b a r b i e r i	1
COL name VAL francesco stephen barbieri COL name_chars VAL f r a n c e s c o   s t e p h e n   b a r b i e r i	COL name VAL francesco barbieri COL name_chars VAL f r a n c e s c o   b a r b i e r i	1
COL name VAL francesco dany barbieri COL name_chars VAL f r a n c e s c o   d a n y   b a r b i e r i	COL name VAL francesco barbieri COL name_chars VAL f r a n c e s c o   b a r b i e r i	1
COL name VAL francesco jayda barbieri COL name_chars VAL f r a n c e s c o   j a y d a   b a r b i e r i	COL name VAL francesco barbieri COL name_chars VAL f r a n c e s c o   b a r b i e r i	1
COL name VAL francesco enrique barbieri COL name_chars VAL f r a n c e s c o   e n r i q u e   b a r b i e r i	COL name VAL francesco barbieri COL name_chars VAL f r a n c e s c o   b a r b i e r i	1
COL name VAL edwin bente bryant COL name_chars VAL e d w i n   b e n t e   b r y a n t	COL name VAL edwin bryant COL name_chars VAL e d w i n   b r y a n t	1
COL name VAL edwin alfonso bryant COL name_chars VAL e d w i n   a l f o n s o   b r y a n t	COL name VAL edwin bryant COL name_chars VAL e d w i n   b r y a n t	1
COL name VAL edwin marc bryant COL name_chars VAL e d w i n   m a r c   b r y a n t	COL name VAL edwin bryant COL name_chars VAL e d w i n   b r y a n t	1
COL name VAL marius amy larsen COL name_chars VAL m a r i u s   a m y   l a r s e n	COL name VAL marius larsen COL name_chars VAL m a r i u s   l a r s e n	1
COL name VAL kristoffer robert klaesson COL name_chars VAL k r i s t o f f e r   r o b e r t   k l a e s s o n	COL name VAL kristoffer klaesson COL name_chars VAL k r i s t o f f e r   k l a e s s o n	1
COL name VAL catherine jack verleysen COL name_chars VAL c a t h e r i n e   j a c k   v e r l e y s e n	COL name VAL catherine verleysen COL name_chars VAL c a t h e r i n e   v e r l e y s e n	1
COL name VAL alfredo mohammad fioravanti COL name_chars VAL a l f r e d o   m o h a m m a d   f i o r a v a n t i	COL name VAL alfredo fioravanti COL name_chars VAL a l f r e d o   f i o r a v a n t i	1
COL name VAL andreas elaine ton COL name_chars VAL a n d r e a s   e l a i n e   t o n	COL name VAL andreas ton COL name_chars VAL a n d r e a s   t o n	1
COL name VAL ronald stephen de sousa COL name_chars VAL r o n a l d   s t e p h e n   d e   s o u s a	COL name VAL ronald de sousa COL name_chars VAL r o n a l d   d e   s o u s a	1
COL name VAL felix sylvester myhre COL name_chars VAL f e l i x   s y l v e s t e r   m y h r e	COL name VAL felix myhre COL name_chars VAL f e l i x   m y h r e	1
COL name VAL therese john åsland COL name_chars VAL t h e r e s e   j o h n   å s l a n d	COL name VAL therese åsland COL name_chars VAL t h e r e s e   å s l a n d	1
COL name VAL jésus john barreda COL name_chars VAL j é s u s   j o h n   b a r r e d a	COL name VAL jésus barreda COL name_chars VAL j é s u s   b a r r e d a	1
COL name VAL jésus alessandro barreda COL name_chars VAL j é s u s   a l e s s a n d r o   b a r r e d a	COL name VAL jésus barreda COL name_chars VAL j é s u s   b a r r e d a	1
COL name VAL yossi roger hadar COL name_chars VAL y o s s i   r o g e r   h a d a r	COL name VAL yossi hadar COL name_chars VAL y o s s i   h a d a r	1
COL name VAL andy rose ton COL name_chars VAL a n d y   r o s e   t o n	COL name VAL andy ton COL name_chars VAL a n d y   t o n	1
COL name VAL maria byron barreda COL name_chars VAL m a r i a   b y r o n   b a r r e d a	COL name VAL maria barreda COL name_chars VAL m a r i a   b a r r e d a	1
COL name VAL maria ellen barreda COL name_chars VAL m a r i a   e l l e n   b a r r e d a	COL name VAL maria barreda COL name_chars VAL m a r i a   b a r r e d a	1
COL name VAL karl dina kälin COL name_chars VAL k a r l   d i n a   k ä l i n	COL name VAL karl kälin COL name_chars VAL k a r l   k ä l i n	1
COL name VAL patrick joshua bühlmann COL name_chars VAL p a t r i c k   j o s h u a   b ü h l m a n n	COL name VAL patrick bühlmann COL name_chars VAL p a t r i c k   b ü h l m a n n	1
COL name VAL manuel david fernández COL name_chars VAL m a n u e l   d a v i d   f e r n á n d e z	COL name VAL manuel fernández COL name_chars VAL m a n u e l   f e r n á n d e z	1
COL name VAL tomás gad fernández COL name_chars VAL t o m á s   g a d   f e r n á n d e z	COL name VAL tomás fernández COL name_chars VAL t o m á s   f e r n á n d e z	1
COL name VAL élisabeth james duparc COL name_chars VAL é l i s a b e t h   j a m e s   d u p a r c	COL name VAL élisabeth duparc COL name_chars VAL é l i s a b e t h   d u p a r c	1
COL name VAL justin floyd vulliamy COL name_chars VAL j u s t i n   f l o y d   v u l l i a m y	COL name VAL justin vulliamy COL name_chars VAL j u s t i n   v u l l i a m y	1
COL name VAL bettina colin kühn COL name_chars VAL b e t t i n a   c o l i n   k ü h n	COL name VAL bettina kühn COL name_chars VAL b e t t i n a   k ü h n	1
COL name VAL lars adrian schjetne COL name_chars VAL l a r s   a d r i a n   s c h j e t n e	COL name VAL lars schjetne COL name_chars VAL l a r s   s c h j e t n e	1
COL name VAL lars caroline schjetne COL name_chars VAL l a r s   c a r o l i n e   s c h j e t n e	COL name VAL lars schjetne COL name_chars VAL l a r s   s c h j e t n e	1
COL name VAL lars david schjetne COL name_chars VAL l a r s   d a v i d   s c h j e t n e	COL name VAL lars schjetne COL name_chars VAL l a r s   s c h j e t n e	1
COL name VAL jakob thora tromsdal COL name_chars VAL j a k o b   t h o r a   t r o m s d a l	COL name VAL jakob tromsdal COL name_chars VAL j a k o b   t r o m s d a l	1
COL name VAL jakob nicola tromsdal COL name_chars VAL j a k o b   n i c o l a   t r o m s d a l	COL name VAL jakob tromsdal COL name_chars VAL j a k o b   t r o m s d a l	1
COL name VAL rikke knut nygard COL name_chars VAL r i k k e   k n u t   n y g a r d	COL name VAL rikke nygard COL name_chars VAL r i k k e   n y g a r d	1
COL name VAL rikke aminé bogetveit COL name_chars VAL r i k k e   a m i n é   b o g e t v e i t	COL name VAL rikke bogetveit COL name_chars VAL r i k k e   b o g e t v e i t	1
COL name VAL gabrielle grace lie COL name_chars VAL g a b r i e l l e   g r a c e   l i e	COL name VAL gabrielle lie COL name_chars VAL g a b r i e l l e   l i e	1
COL name VAL gabrielle pete lie COL name_chars VAL g a b r i e l l e   p e t e   l i e	COL name VAL gabrielle lie COL name_chars VAL g a b r i e l l e   l i e	1
COL name VAL mia mark huse COL name_chars VAL m i a   m a r k   h u s e	COL name VAL mia huse COL name_chars VAL m i a   h u s e	1
COL name VAL guido carlos pizarro COL name_chars VAL g u i d o   c a r l o s   p i z a r r o	COL name VAL guido pizarro COL name_chars VAL g u i d o   p i z a r r o	1
COL name VAL alexandre francisco crépet COL name_chars VAL a l e x a n d r e   f r a n c i s c o   c r é p e t	COL name VAL alexandre crépet COL name_chars VAL a l e x a n d r e   c r é p e t	1
COL name VAL michelangelo p. di pietro COL name_chars VAL m i c h e l a n g e l o   p .   d i   p i e t r o	COL name VAL michelangelo di pietro COL name_chars VAL m i c h e l a n g e l o   d i   p i e t r o	1
COL name VAL michelangelo nan di pietro COL name_chars VAL m i c h e l a n g e l o   n a n   d i   p i e t r o	COL name VAL michelangelo di pietro COL name_chars VAL m i c h e l a n g e l o   d i   p i e t r o	1
COL name VAL michelangelo jesse di pietro COL name_chars VAL m i c h e l a n g e l o   j e s s e   d i   p i e t r o	COL name VAL michelangelo di pietro COL name_chars VAL m i c h e l a n g e l o   d i   p i e t r o	1
COL name VAL michelangelo eric di pietro COL name_chars VAL m i c h e l a n g e l o   e r i c   d i   p i e t r o	COL name VAL michelangelo di pietro COL name_chars VAL m i c h e l a n g e l o   d i   p i e t r o	1
COL name VAL pietro cristopher adami COL name_chars VAL p i e t r o   c r i s t o p h e r   a d a m i	COL name VAL pietro adami COL name_chars VAL p i e t r o   a d a m i	1
COL name VAL diego erika da silva COL name_chars VAL d i e g o   e r i k a   d a   s i l v a	COL name VAL diego da silva COL name_chars VAL d i e g o   d a   s i l v a	1
COL name VAL diego jürg giaretta COL name_chars VAL d i e g o   j ü r g   g i a r e t t a	COL name VAL diego giaretta COL name_chars VAL d i e g o   g i a r e t t a	1
COL name VAL erwan robert käser COL name_chars VAL e r w a n   r o b e r t   k ä s e r	COL name VAL erwan käser COL name_chars VAL e r w a n   k ä s e r	1
COL name VAL philippe gül fauchet COL name_chars VAL p h i l i p p e   g ü l   f a u c h e t	COL name VAL philippe fauchet COL name_chars VAL p h i l i p p e   f a u c h e t	1
COL name VAL max c. fauchet COL name_chars VAL m a x   c .   f a u c h e t	COL name VAL max fauchet COL name_chars VAL m a x   f a u c h e t	1
COL name VAL philippe siegfried fauchet COL name_chars VAL p h i l i p p e   s i e g f r i e d   f a u c h e t	COL name VAL philippe fauchet COL name_chars VAL p h i l i p p e   f a u c h e t	1
COL name VAL max elizabeth fauchet COL name_chars VAL m a x   e l i z a b e t h   f a u c h e t	COL name VAL max fauchet COL name_chars VAL m a x   f a u c h e t	1
COL name VAL kim-joy joel hewlett COL name_chars VAL k i m - j o y   j o e l   h e w l e t t	COL name VAL kim-joy hewlett COL name_chars VAL k i m - j o y   h e w l e t t	1
COL name VAL kim-joy edwin hewlett COL name_chars VAL k i m - j o y   e d w i n   h e w l e t t	COL name VAL kim-joy hewlett COL name_chars VAL k i m - j o y   h e w l e t t	1
COL name VAL klara john sporsem COL name_chars VAL k l a r a   j o h n   s p o r s e m	COL name VAL klara sporsem COL name_chars VAL k l a r a   s p o r s e m	1
COL name VAL friedrich melinda sustris COL name_chars VAL f r i e d r i c h   m e l i n d a   s u s t r i s	COL name VAL friedrich sustris COL name_chars VAL f r i e d r i c h   s u s t r i s	1
COL name VAL friedrich erik sustris COL name_chars VAL f r i e d r i c h   e r i k   s u s t r i s	COL name VAL friedrich sustris COL name_chars VAL f r i e d r i c h   s u s t r i s	1
COL name VAL friedrich clive sustris COL name_chars VAL f r i e d r i c h   c l i v e   s u s t r i s	COL name VAL friedrich sustris COL name_chars VAL f r i e d r i c h   s u s t r i s	1
COL name VAL friedrich gül sustris COL name_chars VAL f r i e d r i c h   g ü l   s u s t r i s	COL name VAL friedrich sustris COL name_chars VAL f r i e d r i c h   s u s t r i s	1
COL name VAL friedrich david sustris COL name_chars VAL f r i e d r i c h   d a v i d   s u s t r i s	COL name VAL friedrich sustris COL name_chars VAL f r i e d r i c h   s u s t r i s	1
COL name VAL friedrich dalila sustris COL name_chars VAL f r i e d r i c h   d a l i l a   s u s t r i s	COL name VAL friedrich sustris COL name_chars VAL f r i e d r i c h   s u s t r i s	1
COL name VAL friedrich václav sustris COL name_chars VAL f r i e d r i c h   v á c l a v   s u s t r i s	COL name VAL friedrich sustris COL name_chars VAL f r i e d r i c h   s u s t r i s	1
COL name VAL friedrich filippo sustris COL name_chars VAL f r i e d r i c h   f i l i p p o   s u s t r i s	COL name VAL friedrich sustris COL name_chars VAL f r i e d r i c h   s u s t r i s	1
COL name VAL friedrich patricia sustris COL name_chars VAL f r i e d r i c h   p a t r i c i a   s u s t r i s	COL name VAL friedrich sustris COL name_chars VAL f r i e d r i c h   s u s t r i s	1
COL name VAL friedrich bobbi sustris COL name_chars VAL f r i e d r i c h   b o b b i   s u s t r i s	COL name VAL friedrich sustris COL name_chars VAL f r i e d r i c h   s u s t r i s	1
COL name VAL friedrich john sustris COL name_chars VAL f r i e d r i c h   j o h n   s u s t r i s	COL name VAL friedrich sustris COL name_chars VAL f r i e d r i c h   s u s t r i s	1
COL name VAL friedrich james sustris COL name_chars VAL f r i e d r i c h   j a m e s   s u s t r i s	COL name VAL friedrich sustris COL name_chars VAL f r i e d r i c h   s u s t r i s	1
COL name VAL friedrich delmar sustris COL name_chars VAL f r i e d r i c h   d e l m a r   s u s t r i s	COL name VAL friedrich sustris COL name_chars VAL f r i e d r i c h   s u s t r i s	1
COL name VAL friedrich nicholas sustris COL name_chars VAL f r i e d r i c h   n i c h o l a s   s u s t r i s	COL name VAL friedrich sustris COL name_chars VAL f r i e d r i c h   s u s t r i s	1
COL name VAL friedrich david sustris COL name_chars VAL f r i e d r i c h   d a v i d   s u s t r i s	COL name VAL friedrich sustris COL name_chars VAL f r i e d r i c h   s u s t r i s	1
COL name VAL friedrich anabel sustris COL name_chars VAL f r i e d r i c h   a n a b e l   s u s t r i s	COL name VAL friedrich sustris COL name_chars VAL f r i e d r i c h   s u s t r i s	1
COL name VAL friedrich todd sustris COL name_chars VAL f r i e d r i c h   t o d d   s u s t r i s	COL name VAL friedrich sustris COL name_chars VAL f r i e d r i c h   s u s t r i s	1
COL name VAL friedrich johan sustris COL name_chars VAL f r i e d r i c h   j o h a n   s u s t r i s	COL name VAL friedrich sustris COL name_chars VAL f r i e d r i c h   s u s t r i s	1
COL name VAL friedrich s. sustris COL name_chars VAL f r i e d r i c h   s .   s u s t r i s	COL name VAL friedrich sustris COL name_chars VAL f r i e d r i c h   s u s t r i s	1
COL name VAL friedrich tebey sustris COL name_chars VAL f r i e d r i c h   t e b e y   s u s t r i s	COL name VAL friedrich sustris COL name_chars VAL f r i e d r i c h   s u s t r i s	1
COL name VAL peter gilbert müller COL name_chars VAL p e t e r   g i l b e r t   m ü l l e r	COL name VAL peter müller COL name_chars VAL p e t e r   m ü l l e r	1
COL name VAL blanche melissa charlet COL name_chars VAL b l a n c h e   m e l i s s a   c h a r l e t	COL name VAL blanche charlet COL name_chars VAL b l a n c h e   c h a r l e t	1
COL name VAL valentine iselin charlet COL name_chars VAL v a l e n t i n e   i s e l i n   c h a r l e t	COL name VAL valentine charlet COL name_chars VAL v a l e n t i n e   c h a r l e t	1
COL name VAL carl federico colpaert COL name_chars VAL c a r l   f e d e r i c o   c o l p a e r t	COL name VAL carl colpaert COL name_chars VAL c a r l   c o l p a e r t	1
COL name VAL tancrède eduardo dumas COL name_chars VAL t a n c r è d e   e d u a r d o   d u m a s	COL name VAL tancrède dumas COL name_chars VAL t a n c r è d e   d u m a s	1
COL name VAL tancrède charles dumas COL name_chars VAL t a n c r è d e   c h a r l e s   d u m a s	COL name VAL tancrède dumas COL name_chars VAL t a n c r è d e   d u m a s	1
COL name VAL tancrède christopher dumas COL name_chars VAL t a n c r è d e   c h r i s t o p h e r   d u m a s	COL name VAL tancrède dumas COL name_chars VAL t a n c r è d e   d u m a s	1
COL name VAL tancrède franco dumas COL name_chars VAL t a n c r è d e   f r a n c o   d u m a s	COL name VAL tancrède dumas COL name_chars VAL t a n c r è d e   d u m a s	1
COL name VAL tancrède marquis dumas COL name_chars VAL t a n c r è d e   m a r q u i s   d u m a s	COL name VAL tancrède dumas COL name_chars VAL t a n c r è d e   d u m a s	1
COL name VAL nico valerie brüngger COL name_chars VAL n i c o   v a l e r i e   b r ü n g g e r	COL name VAL nico brüngger COL name_chars VAL n i c o   b r ü n g g e r	1
COL name VAL nico johan brüngger COL name_chars VAL n i c o   j o h a n   b r ü n g g e r	COL name VAL nico brüngger COL name_chars VAL n i c o   b r ü n g g e r	1
COL name VAL gregory erika wüthrich COL name_chars VAL g r e g o r y   e r i k a   w ü t h r i c h	COL name VAL gregory wüthrich COL name_chars VAL g r e g o r y   w ü t h r i c h	1
COL name VAL arthur nancy varney COL name_chars VAL a r t h u r   n a n c y   v a r n e y	COL name VAL arthur varney COL name_chars VAL a r t h u r   v a r n e y	1
COL name VAL arthur john de carrick varney COL name_chars VAL a r t h u r   j o h n   d e   c a r r i c k   v a r n e y	COL name VAL arthur varney COL name_chars VAL a r t h u r   v a r n e y	1
COL name VAL gaetano oleg mignani COL name_chars VAL g a e t a n o   o l e g   m i g n a n i	COL name VAL gaetano mignani COL name_chars VAL g a e t a n o   m i g n a n i	1
COL name VAL heidi ralph ellingsen COL name_chars VAL h e i d i   r a l p h   e l l i n g s e n	COL name VAL heidi ellingsen COL name_chars VAL h e i d i   e l l i n g s e n	1
COL name VAL frode raymond hegland COL name_chars VAL f r o d e   r a y m o n d   h e g l a n d	COL name VAL frode hegland COL name_chars VAL f r o d e   h e g l a n d	1
COL name VAL alexander alan hegland COL name_chars VAL a l e x a n d e r   a l a n   h e g l a n d	COL name VAL alexander hegland COL name_chars VAL a l e x a n d e r   h e g l a n d	1
COL name VAL agustín edward garcía COL name_chars VAL a g u s t í n   e d w a r d   g a r c í a	COL name VAL agustín garcía COL name_chars VAL a g u s t í n   g a r c í a	1
COL name VAL rodrigo sarah de borja COL name_chars VAL r o d r i g o   s a r a h   d e   b o r j a	COL name VAL rodrigo de borja COL name_chars VAL r o d r i g o   d e   b o r j a	1
COL name VAL julián ruth lópez COL name_chars VAL j u l i á n   r u t h   l ó p e z	COL name VAL julián lópez COL name_chars VAL j u l i á n   l ó p e z	1
COL name VAL julián alondra lópez COL name_chars VAL j u l i á n   a l o n d r a   l ó p e z	COL name VAL julián lópez COL name_chars VAL j u l i á n   l ó p e z	1
COL name VAL otto david bühler COL name_chars VAL o t t o   d a v i d   b ü h l e r	COL name VAL otto bühler COL name_chars VAL o t t o   b ü h l e r	1
COL name VAL otto katharine bühler COL name_chars VAL o t t o   k a t h a r i n e   b ü h l e r	COL name VAL otto bühler COL name_chars VAL o t t o   b ü h l e r	1
COL name VAL otto frode schläpfer COL name_chars VAL o t t o   f r o d e   s c h l ä p f e r	COL name VAL otto schläpfer COL name_chars VAL o t t o   s c h l ä p f e r	1
COL name VAL ralph ignace rüegg COL name_chars VAL r a l p h   i g n a c e   r ü e g g	COL name VAL ralph rüegg COL name_chars VAL r a l p h   r ü e g g	1
COL name VAL andré øystein niederhäuser COL name_chars VAL a n d r é   ø y s t e i n   n i e d e r h ä u s e r	COL name VAL andré niederhäuser COL name_chars VAL a n d r é   n i e d e r h ä u s e r	1
COL name VAL valentina art bosetti COL name_chars VAL v a l e n t i n a   a r t   b o s e t t i	COL name VAL valentina bosetti COL name_chars VAL v a l e n t i n a   b o s e t t i	1
COL name VAL umberto césar romano COL name_chars VAL u m b e r t o   c é s a r   r o m a n o	COL name VAL umberto romano COL name_chars VAL u m b e r t o   r o m a n o	1
COL name VAL leonarda william casiraghi COL name_chars VAL l e o n a r d a   w i l l i a m   c a s i r a g h i	COL name VAL leonarda casiraghi COL name_chars VAL l e o n a r d a   c a s i r a g h i	1
COL name VAL george duwayne molteno COL name_chars VAL g e o r g e   d u w a y n e   m o l t e n o	COL name VAL george molteno COL name_chars VAL g e o r g e   m o l t e n o	1
COL name VAL george larry molteno COL name_chars VAL g e o r g e   l a r r y   m o l t e n o	COL name VAL george molteno COL name_chars VAL g e o r g e   m o l t e n o	1
COL name VAL gianfranco jim felli COL name_chars VAL g i a n f r a n c o   j i m   f e l l i	COL name VAL gianfranco felli COL name_chars VAL g i a n f r a n c o   f e l l i	1
COL name VAL eva karina rønning COL name_chars VAL e v a   k a r i n a   r ø n n i n g	COL name VAL eva rønning COL name_chars VAL e v a   r ø n n i n g	1
COL name VAL eva sally fodor COL name_chars VAL e v a   s a l l y   f o d o r	COL name VAL eva fodor COL name_chars VAL e v a   f o d o r	1
COL name VAL gret alvina mann COL name_chars VAL g r e t   a l v i n a   m a n n	COL name VAL gret mann COL name_chars VAL g r e t   m a n n	1
COL name VAL gret tim moser COL name_chars VAL g r e t   t i m   m o s e r	COL name VAL gret moser COL name_chars VAL g r e t   m o s e r	1
COL name VAL jorunn philip buckley COL name_chars VAL j o r u n n   p h i l i p   b u c k l e y	COL name VAL jorunn buckley COL name_chars VAL j o r u n n   b u c k l e y	1
COL name VAL jorunn salim buckley COL name_chars VAL j o r u n n   s a l i m   b u c k l e y	COL name VAL jorunn buckley COL name_chars VAL j o r u n n   b u c k l e y	1
COL name VAL jorunn teresa buckley COL name_chars VAL j o r u n n   t e r e s a   b u c k l e y	COL name VAL jorunn buckley COL name_chars VAL j o r u n n   b u c k l e y	1
COL name VAL joan domingo massagué COL name_chars VAL j o a n   d o m i n g o   m a s s a g u é	COL name VAL joan massagué COL name_chars VAL j o a n   m a s s a g u é	1
COL name VAL joan kenza massagué COL name_chars VAL j o a n   k e n z a   m a s s a g u é	COL name VAL joan massagué COL name_chars VAL j o a n   m a s s a g u é	1
COL name VAL joan nila massagué COL name_chars VAL j o a n   n i l a   m a s s a g u é	COL name VAL joan massagué COL name_chars VAL j o a n   m a s s a g u é	1
COL name VAL joan federico massagué COL name_chars VAL j o a n   f e d e r i c o   m a s s a g u é	COL name VAL joan massagué COL name_chars VAL j o a n   m a s s a g u é	1
COL name VAL david richard rodrigo COL name_chars VAL d a v i d   r i c h a r d   r o d r i g o	COL name VAL david rodrigo COL name_chars VAL d a v i d   r o d r i g o	1
COL name VAL miguel ángel william araújo iglesias COL name_chars VAL m i g u e l   á n g e l   w i l l i a m   a r a ú j o   i g l e s i a s	COL name VAL miguel ángel araújo iglesias COL name_chars VAL m i g u e l   á n g e l   a r a ú j o   i g l e s i a s	1
COL name VAL josé manuel kurt egea COL name_chars VAL j o s é   m a n u e l   k u r t   e g e a	COL name VAL josé manuel egea COL name_chars VAL j o s é   m a n u e l   e g e a	1
COL name VAL joaquín zoe novoa COL name_chars VAL j o a q u í n   z o e   n o v o a	COL name VAL joaquín novoa COL name_chars VAL j o a q u í n   n o v o a	1
COL name VAL rodolphe jim cuendet COL name_chars VAL r o d o l p h e   j i m   c u e n d e t	COL name VAL rodolphe cuendet COL name_chars VAL r o d o l p h e   c u e n d e t	1
COL name VAL silvan dina büchli COL name_chars VAL s i l v a n   d i n a   b ü c h l i	COL name VAL silvan büchli COL name_chars VAL s i l v a n   b ü c h l i	1
COL name VAL henry henri müller COL name_chars VAL h e n r y   h e n r i   m ü l l e r	COL name VAL henry müller COL name_chars VAL h e n r y   m ü l l e r	1
COL name VAL leo robert pescarolo COL name_chars VAL l e o   r o b e r t   p e s c a r o l o	COL name VAL leo pescarolo COL name_chars VAL l e o   p e s c a r o l o	1
COL name VAL dany laurie da silva COL name_chars VAL d a n y   l a u r i e   d a   s i l v a	COL name VAL dany da silva COL name_chars VAL d a n y   d a   s i l v a	1
COL name VAL petra phil walczewski COL name_chars VAL p e t r a   p h i l   w a l c z e w s k i	COL name VAL petra walczewski COL name_chars VAL p e t r a   w a l c z e w s k i	1
COL name VAL marie charles aubert COL name_chars VAL m a r i e   c h a r l e s   a u b e r t	COL name VAL marie aubert COL name_chars VAL m a r i e   a u b e r t	1
COL name VAL mercia barbara harrison COL name_chars VAL m e r c i a   b a r b a r a   h a r r i s o n	COL name VAL mercia harrison COL name_chars VAL m e r c i a   h a r r i s o n	1
COL name VAL martin patrícia tschudy COL name_chars VAL m a r t i n   p a t r í c i a   t s c h u d y	COL name VAL martin tschudy COL name_chars VAL m a r t i n   t s c h u d y	1
COL name VAL martin carly tschudi COL name_chars VAL m a r t i n   c a r l y   t s c h u d i	COL name VAL martin tschudi COL name_chars VAL m a r t i n   t s c h u d i	1
COL name VAL mercia liz tinker COL name_chars VAL m e r c i a   l i z   t i n k e r	COL name VAL mercia tinker COL name_chars VAL m e r c i a   t i n k e r	1
COL name VAL josé edward santiago concha COL name_chars VAL j o s é   e d w a r d   s a n t i a g o   c o n c h a	COL name VAL josé santiago concha COL name_chars VAL j o s é   s a n t i a g o   c o n c h a	1
COL name VAL antonio maria jiménez COL name_chars VAL a n t o n i o   m a r i a   j i m é n e z	COL name VAL antonio jiménez COL name_chars VAL a n t o n i o   j i m é n e z	1
COL name VAL nathaniel jane andré COL name_chars VAL n a t h a n i e l   j a n e   a n d r é	COL name VAL nathaniel andré COL name_chars VAL n a t h a n i e l   a n d r é	1
COL name VAL carlos henry arroyo COL name_chars VAL c a r l o s   h e n r y   a r r o y o	COL name VAL carlos arroyo COL name_chars VAL c a r l o s   a r r o y o	1
COL name VAL adolfo michel prada COL name_chars VAL a d o l f o   m i c h e l   p r a d a	COL name VAL adolfo prada COL name_chars VAL a d o l f o   p r a d a	1
COL name VAL julien benjamin livi COL name_chars VAL j u l i e n   b e n j a m i n   l i v i	COL name VAL julien livi COL name_chars VAL j u l i e n   l i v i	1
COL name VAL manfredi irène lefebvre COL name_chars VAL m a n f r e d i   i r è n e   l e f e b v r e	COL name VAL manfredi lefebvre COL name_chars VAL m a n f r e d i   l e f e b v r e	1
COL name VAL manfredi william lefebvre COL name_chars VAL m a n f r e d i   w i l l i a m   l e f e b v r e	COL name VAL manfredi lefebvre COL name_chars VAL m a n f r e d i   l e f e b v r e	1
COL name VAL manfredi mary lefebvre COL name_chars VAL m a n f r e d i   m a r y   l e f e b v r e	COL name VAL manfredi lefebvre COL name_chars VAL m a n f r e d i   l e f e b v r e	1
COL name VAL elsa esnoult de michael je taime fabrizio horváth COL name_chars VAL e l s a   e s n o u l t   d e   m i c h a e l   j e   t a i m e   f a b r i z i o   h o r v á t h	COL name VAL elsa esnoult de michael je taime horváth COL name_chars VAL e l s a   e s n o u l t   d e   m i c h a e l   j e   t a i m e   h o r v á t h	1
COL name VAL elsa esnoult de michael je taime michael horváth COL name_chars VAL e l s a   e s n o u l t   d e   m i c h a e l   j e   t a i m e   m i c h a e l   h o r v á t h	COL name VAL elsa esnoult de michael je taime horváth COL name_chars VAL e l s a   e s n o u l t   d e   m i c h a e l   j e   t a i m e   h o r v á t h	1
COL name VAL markus tarek bösiger COL name_chars VAL m a r k u s   t a r e k   b ö s i g e r	COL name VAL markus bösiger COL name_chars VAL m a r k u s   b ö s i g e r	1
COL name VAL conrad christopher buff COL name_chars VAL c o n r a d   c h r i s t o p h e r   b u f f	COL name VAL conrad buff COL name_chars VAL c o n r a d   b u f f	1
COL name VAL conrad maria buff COL name_chars VAL c o n r a d   m a r i a   b u f f	COL name VAL conrad buff COL name_chars VAL c o n r a d   b u f f	1
COL name VAL joão samantha oliveira COL name_chars VAL j o ã o   s a m a n t h a   o l i v e i r a	COL name VAL joão oliveira COL name_chars VAL j o ã o   o l i v e i r a	1
COL name VAL e. jerry garcin COL name_chars VAL e .   j e r r y   g a r c i n	COL name VAL e. garcin COL name_chars VAL e .   g a r c i n	1
COL name VAL e. gian garcin COL name_chars VAL e .   g i a n   g a r c i n	COL name VAL e. garcin COL name_chars VAL e .   g a r c i n	1
COL name VAL francine juma lacqua COL name_chars VAL f r a n c i n e   j u m a   l a c q u a	COL name VAL francine lacqua COL name_chars VAL f r a n c i n e   l a c q u a	1
COL name VAL kat kurt arney COL name_chars VAL k a t   k u r t   a r n e y	COL name VAL kat arney COL name_chars VAL k a t   a r n e y	1
COL name VAL sarah robert suphellen COL name_chars VAL s a r a h   r o b e r t   s u p h e l l e n	COL name VAL sarah suphellen COL name_chars VAL s a r a h   s u p h e l l e n	1
COL name VAL sarah david suphellen COL name_chars VAL s a r a h   d a v i d   s u p h e l l e n	COL name VAL sarah suphellen COL name_chars VAL s a r a h   s u p h e l l e n	1
COL name VAL michael magda wollan COL name_chars VAL m i c h a e l   m a g d a   w o l l a n	COL name VAL michael wollan COL name_chars VAL m i c h a e l   w o l l a n	1
COL name VAL lars scott olson COL name_chars VAL l a r s   s c o t t   o l s o n	COL name VAL lars olson COL name_chars VAL l a r s   o l s o n	1
COL name VAL jens andré opsahl COL name_chars VAL j e n s   a n d r é   o p s a h l	COL name VAL jens opsahl COL name_chars VAL j e n s   o p s a h l	1
COL name VAL john lise oppegaard COL name_chars VAL j o h n   l i s e   o p p e g a a r d	COL name VAL john oppegaard COL name_chars VAL j o h n   o p p e g a a r d	1
COL name VAL auguste norbert garcin COL name_chars VAL a u g u s t e   n o r b e r t   g a r c i n	COL name VAL auguste garcin COL name_chars VAL a u g u s t e   g a r c i n	1
COL name VAL auguste andreas garcin COL name_chars VAL a u g u s t e   a n d r e a s   g a r c i n	COL name VAL auguste garcin COL name_chars VAL a u g u s t e   g a r c i n	1
COL name VAL josé kamal espelius COL name_chars VAL j o s é   k a m a l   e s p e l i u s	COL name VAL josé espelius COL name_chars VAL j o s é   e s p e l i u s	1
