COL name VAL ivar kurt nørve	COL name VAL ivar nørve	1
COL name VAL tore paulette heyerdahl	COL name VAL tore heyerdahl	1
COL name VAL tore gregory heyerdahl	COL name VAL tore heyerdahl	1
COL name VAL peter maria bredal	COL name VAL peter bredal	1
COL name VAL ingeborg didier finnsdóttir	COL name VAL ingeborg finnsdóttir	1
COL name VAL ingeborg andreas finnsdóttir	COL name VAL ingeborg finnsdóttir	1
COL name VAL ingeborg hameed finnsdóttir	COL name VAL ingeborg finnsdóttir	1
COL name VAL ivar maeva nordkild	COL name VAL ivar nordkild	1
COL name VAL andrew x. stoltenberg	COL name VAL andrew stoltenberg	1
COL name VAL andrew bernhard stoltenberg	COL name VAL andrew stoltenberg	1
COL name VAL astrid luz johannessen	COL name VAL astrid johannessen	1
COL name VAL vlasta manuel vrána	COL name VAL vlasta vrána	1
COL name VAL werner willy christie	COL name VAL werner christie	1
COL name VAL bjørn mary heyerdahl	COL name VAL bjørn heyerdahl	1
COL name VAL bjørn federico heyerdahl	COL name VAL bjørn heyerdahl	1
COL name VAL øystein yael halfdansson	COL name VAL øystein halfdansson	1
COL name VAL eystein barbara halfdansson	COL name VAL eystein halfdansson	1
COL name VAL øystein cristina halfdansson	COL name VAL øystein halfdansson	1
COL name VAL eystein norman halfdansson	COL name VAL eystein halfdansson	1
COL name VAL øystein samuel halfdansson	COL name VAL øystein halfdansson	1
COL name VAL eystein adolf halfdansson	COL name VAL eystein halfdansson	1
COL name VAL arne mina røed	COL name VAL arne røed	1
COL name VAL arne eve røed	COL name VAL arne røed	1
COL name VAL arne arghavan røed	COL name VAL arne røed	1
COL name VAL camillo adam everardi	COL name VAL camillo everardi	1
COL name VAL camille henry everardi	COL name VAL camille everardi	1
COL name VAL alexandra mike joner	COL name VAL alexandra joner	1
COL name VAL solfrid christopher heier	COL name VAL solfrid heier	1
COL name VAL christophe christophe schatteman	COL name VAL christophe schatteman	1
COL name VAL erik gad schjerven	COL name VAL erik schjerven	1
COL name VAL gard levi eidsvold	COL name VAL gard eidsvold	1
COL name VAL bjørnstjerne frida eidsvold	COL name VAL bjørnstjerne eidsvold	1
COL name VAL harry idan lien	COL name VAL harry lien	1
COL name VAL olaf denis tryggvason	COL name VAL olaf tryggvason	1
COL name VAL victor michael verschueren	COL name VAL victor verschueren	1
COL name VAL paulette tobias cooper	COL name VAL paulette cooper	1
COL name VAL august federico olsen	COL name VAL august olsen	1
COL name VAL cecilie pat mosli	COL name VAL cecilie mosli	1
COL name VAL cecilie george mosli	COL name VAL cecilie mosli	1
COL name VAL sondre bryan tronstad	COL name VAL sondre tronstad	1
COL name VAL truls john korsæth	COL name VAL truls korsæth	1
COL name VAL truls frank korsæth	COL name VAL truls korsæth	1
COL name VAL truls edwin korsæth	COL name VAL truls korsæth	1
COL name VAL tone cédric lima	COL name VAL tone lima	1
COL name VAL ingrid zoe wold	COL name VAL ingrid wold	1
COL name VAL henning rosario olsen	COL name VAL henning olsen	1
COL name VAL magnus john eriksson	COL name VAL magnus eriksson	1
COL name VAL maunu mari eriksson	COL name VAL maunu eriksson	1
COL name VAL magnus abby eriksson	COL name VAL magnus eriksson	1
COL name VAL maunu george eriksson	COL name VAL maunu eriksson	1
COL name VAL øystein bates magnusson	COL name VAL øystein magnusson	1
COL name VAL eysteinn agustín magnusson	COL name VAL eysteinn magnusson	1
COL name VAL sigurd bernardo munn	COL name VAL sigurd munn	1
COL name VAL sigurd elizabeth munn	COL name VAL sigurd munn	1
COL name VAL sigurd sandra munn	COL name VAL sigurd munn	1
COL name VAL gunnbjörn jean-pierre ulfsson	COL name VAL gunnbjörn ulfsson	1
COL name VAL stéphanie william van vyve	COL name VAL stéphanie van vyve	1
COL name VAL vivian minnie miessen	COL name VAL vivian miessen	1
COL name VAL arnt reza grønbech	COL name VAL arnt grønbech	1
COL name VAL jarl gad goli	COL name VAL jarl goli	1
COL name VAL arnaud bob borchgrave	COL name VAL arnaud borchgrave	1
COL name VAL arnoud nicole de meyer	COL name VAL arnoud de meyer	1
COL name VAL albert ela blanc	COL name VAL albert blanc	1
COL name VAL john samuel robson	COL name VAL john robson	1
COL name VAL ivan robert robson	COL name VAL ivan robson	1
COL name VAL john charles robson	COL name VAL john robson	1
COL name VAL ivan douglas robson	COL name VAL ivan robson	1
COL name VAL john ali robson	COL name VAL john robson	1
COL name VAL ivan sandra robson	COL name VAL ivan robson	1
COL name VAL lise janet nøstvold	COL name VAL lise nøstvold	1
COL name VAL lise james nøstvold	COL name VAL lise nøstvold	1
COL name VAL lise ugbad nøstvold	COL name VAL lise nøstvold	1
COL name VAL kari ryan grønsund	COL name VAL kari grønsund	1
COL name VAL håkon mark ericsson	COL name VAL håkon ericsson	1
COL name VAL eystein blanche magnusson	COL name VAL eystein magnusson	1
COL name VAL øivind francine blunck	COL name VAL øivind blunck	1
COL name VAL magnus alberto barfod	COL name VAL magnus barfod	1
COL name VAL ragnhild kat mikkelsen	COL name VAL ragnhild mikkelsen	1
COL name VAL helene lisa goudin	COL name VAL helene goudin	1
COL name VAL claire merry goudin	COL name VAL claire goudin	1
COL name VAL henry lon van den bulcke	COL name VAL henry van den bulcke	1
COL name VAL jozef diana roey	COL name VAL jozef roey	1
COL name VAL ernest sophie roey	COL name VAL ernest roey	1
COL name VAL jozef kat roey	COL name VAL jozef roey	1
COL name VAL ernest federico roey	COL name VAL ernest roey	1
COL name VAL liv august løberg	COL name VAL liv løberg	1
COL name VAL liv iver løberg	COL name VAL liv løberg	1
COL name VAL liv eva løberg	COL name VAL liv løberg	1
COL name VAL stian marcellus ringstad	COL name VAL stian ringstad	1
COL name VAL ánde michael somby	COL name VAL ánde somby	1
COL name VAL a. david westgard	COL name VAL a. westgard	1
COL name VAL siri moira nordby	COL name VAL siri nordby	1
COL name VAL siri jean nordby	COL name VAL siri nordby	1
COL name VAL ole andrew halvorsen	COL name VAL ole halvorsen	1
COL name VAL yurii rana luhovyj	COL name VAL yurii luhovyj	1
COL name VAL yurii catalina luhovyj	COL name VAL yurii luhovyj	1
COL name VAL yurii david luhovyj	COL name VAL yurii luhovyj	1
COL name VAL henrik stephen bjørdal	COL name VAL henrik bjørdal	1
COL name VAL ole james skjelbred-knutsen	COL name VAL ole skjelbred-knutsen	1
COL name VAL henri ibrahim van den bulcke	COL name VAL henri van den bulcke	1
COL name VAL harald domenico paalgard	COL name VAL harald paalgard	1
COL name VAL bente angelica nordby	COL name VAL bente nordby	1
COL name VAL titti alexandra maartmann	COL name VAL titti maartmann	1
COL name VAL engelbert jean sterckx	COL name VAL engelbert sterckx	1
COL name VAL engelbert josé antonio sterckx	COL name VAL engelbert sterckx	1
COL name VAL kim katie huybrechts	COL name VAL kim huybrechts	1
COL name VAL martin nels torp	COL name VAL martin torp	1
COL name VAL pierre barbara lagrange	COL name VAL pierre lagrange	1
COL name VAL johan john schwartz	COL name VAL johan schwartz	1
COL name VAL eline alessandro brustad	COL name VAL eline brustad	1
COL name VAL petter joseph strand	COL name VAL petter strand	1
COL name VAL aryan doris tari	COL name VAL aryan tari	1
COL name VAL carlos stephen cañas	COL name VAL carlos cañas	1
COL name VAL guri connolly schanke	COL name VAL guri schanke	1
COL name VAL annika stephen schanke	COL name VAL annika schanke	1
COL name VAL frøydis ruth wærsted	COL name VAL frøydis wærsted	1
COL name VAL frøydis thomas wærsted	COL name VAL frøydis wærsted	1
COL name VAL frøydis douglas wærsted	COL name VAL frøydis wærsted	1
COL name VAL hugo richard munthe-kaas	COL name VAL hugo munthe-kaas	1
COL name VAL kjetil douglas try	COL name VAL kjetil try	1
COL name VAL amélie alfredo rorty	COL name VAL amélie rorty	1
COL name VAL amélie craig rorty	COL name VAL amélie rorty	1
COL name VAL arne may eggum	COL name VAL arne eggum	1
COL name VAL lage marc lund	COL name VAL lage lund	1
COL name VAL alain peter dehaze	COL name VAL alain dehaze	1
COL name VAL francisco lars cereijo	COL name VAL francisco cereijo	1
COL name VAL francisco thomas cereijo	COL name VAL francisco cereijo	1
COL name VAL joaquín linda cañas	COL name VAL joaquín cañas	1
COL name VAL marcel kennedyegbus fässler	COL name VAL marcel fässler	1
COL name VAL daniel stephen müller	COL name VAL daniel müller	1
COL name VAL ditlev karina vibe	COL name VAL ditlev vibe	1
COL name VAL peder müge andersen	COL name VAL peder andersen	1
COL name VAL mina richard holtmann	COL name VAL mina holtmann	1
COL name VAL mina randal holtmann	COL name VAL mina holtmann	1
COL name VAL fredrik ann galta	COL name VAL fredrik galta	1
COL name VAL anke roger vanhooren	COL name VAL anke vanhooren	1
COL name VAL antonio magnus suñol	COL name VAL antonio suñol	1
COL name VAL antonio trevor suñol	COL name VAL antonio suñol	1
COL name VAL antonio hashim suñol	COL name VAL antonio suñol	1
COL name VAL antonio liz suñol	COL name VAL antonio suñol	1
COL name VAL gustavo pippa fernández	COL name VAL gustavo fernández	1
COL name VAL valeria elmira pacheco	COL name VAL valeria pacheco	1
COL name VAL óscar j. vizcaíno	COL name VAL óscar vizcaíno	1
COL name VAL óscar jacob vizcaíno	COL name VAL óscar vizcaíno	1
COL name VAL óscar heinrich vizcaíno	COL name VAL óscar vizcaíno	1
COL name VAL óscar nancy vizcaíno	COL name VAL óscar vizcaíno	1
COL name VAL óscar ken vizcaíno	COL name VAL óscar vizcaíno	1
COL name VAL valeria johan antolino	COL name VAL valeria antolino	1
COL name VAL gustavo william huertas	COL name VAL gustavo huertas	1
COL name VAL eysteinn scot erlendsson	COL name VAL eysteinn erlendsson	1
COL name VAL eysteinn emily erlendsson	COL name VAL eysteinn erlendsson	1
COL name VAL eysteinn miguel ángel erlendsson	COL name VAL eysteinn erlendsson	1
COL name VAL eysteinn liz erlendsson	COL name VAL eysteinn erlendsson	1
COL name VAL pål anthony johannessen	COL name VAL pål johannessen	1
COL name VAL petter james olsen	COL name VAL petter olsen	1
COL name VAL yōhei dan miyake	COL name VAL yōhei miyake	1
COL name VAL yōhei chris miyake	COL name VAL yōhei miyake	1
COL name VAL akinsola fred akinyemi	COL name VAL akinsola akinyemi	1
COL name VAL akinsola louisa akinyemi	COL name VAL akinsola akinyemi	1
COL name VAL dilşad evelyn şimşek	COL name VAL dilşad şimşek	1
COL name VAL renee eystein ginsberg	COL name VAL renee ginsberg	1
COL name VAL renee gül rabinowitz	COL name VAL renee rabinowitz	1
COL name VAL umberto danielle cordani	COL name VAL umberto cordani	1
COL name VAL francisco valeria lucini	COL name VAL francisco lucini	1
COL name VAL francisco shavon lucini	COL name VAL francisco lucini	1
COL name VAL juan yohanan pulido	COL name VAL juan pulido	1
COL name VAL yolanda gül heras	COL name VAL yolanda heras	1
COL name VAL blanca stephen hualde	COL name VAL blanca hualde	1
COL name VAL maria alvina suñol	COL name VAL maria suñol	1
COL name VAL maria peter suñol	COL name VAL maria suñol	1
COL name VAL maria karla suñol	COL name VAL maria suñol	1
COL name VAL maria luke suñol	COL name VAL maria suñol	1
COL name VAL yossi alvina peled	COL name VAL yossi peled	1
COL name VAL yossi grace peled	COL name VAL yossi peled	1
COL name VAL alexis megan scholl	COL name VAL alexis scholl	1
COL name VAL andreas jay hanche-olsen	COL name VAL andreas hanche-olsen	1
COL name VAL vinny j. lauwers	COL name VAL vinny lauwers	1
COL name VAL alexis cristopher lefrançois	COL name VAL alexis lefrançois	1
COL name VAL maría victoria baron mateos	COL name VAL maría victoria mateos	1
COL name VAL maría victoria charles mateos	COL name VAL maría victoria mateos	1
COL name VAL delfina didier entrecanales	COL name VAL delfina entrecanales	1
COL name VAL delfina tamar entrecanales	COL name VAL delfina entrecanales	1
COL name VAL henrik dave christiansen	COL name VAL henrik christiansen	1
COL name VAL henrik louis christiansen	COL name VAL henrik christiansen	1
COL name VAL jakob edward bagge	COL name VAL jakob bagge	1
COL name VAL håvard jeffrey nybø	COL name VAL håvard nybø	1
COL name VAL emil david filliol	COL name VAL emil filliol	1
COL name VAL erik donald steen	COL name VAL erik steen	1
COL name VAL magnus w. grødem	COL name VAL magnus grødem	1
COL name VAL marcella sindre jackson	COL name VAL marcella jackson	1
COL name VAL mary de la caridad jackson	COL name VAL mary jackson	1
COL name VAL marcella federico jackson	COL name VAL marcella jackson	1
COL name VAL mary byron jackson	COL name VAL mary jackson	1
COL name VAL pol nova lozano	COL name VAL pol lozano	1
COL name VAL claudia michael cividino	COL name VAL claudia cividino	1
COL name VAL claudia patrick cividino	COL name VAL claudia cividino	1
COL name VAL cristina ray montijano	COL name VAL cristina montijano	1
COL name VAL juan frank jiménez	COL name VAL juan jiménez	1
COL name VAL genaro john gamboa	COL name VAL genaro gamboa	1
COL name VAL gabriel connolly jiménez	COL name VAL gabriel jiménez	1
COL name VAL erik cory wollen	COL name VAL erik wollen	1
COL name VAL carolina dana montijano	COL name VAL carolina montijano	1
COL name VAL andré moshe christiansen	COL name VAL andré christiansen	1
COL name VAL andré ayşe christiansen	COL name VAL andré christiansen	1
COL name VAL sven kyle kristiansen	COL name VAL sven kristiansen	1
COL name VAL peter marquis schärer	COL name VAL peter schärer	1
COL name VAL samy antonio mmaee	COL name VAL samy mmaee	1
COL name VAL morten james solvik	COL name VAL morten solvik	1
COL name VAL morten hannah solvik	COL name VAL morten solvik	1
COL name VAL iselin thomas solheim	COL name VAL iselin solheim	1
COL name VAL maria saray sarro	COL name VAL maria sarro	1
COL name VAL maria tyler sarro	COL name VAL maria sarro	1
COL name VAL maria william sarro	COL name VAL maria sarro	1
COL name VAL maria maria sarro	COL name VAL maria sarro	1
COL name VAL maria boze martinetti	COL name VAL maria martinetti	1
COL name VAL maria john martinetti	COL name VAL maria martinetti	1
COL name VAL maria aurora martinetti	COL name VAL maria martinetti	1
COL name VAL henry cathy loos	COL name VAL henry loos	1
COL name VAL javier rachel esparza	COL name VAL javier esparza	1
COL name VAL javier archibald esparza	COL name VAL javier esparza	1
COL name VAL jorge thomas garcía	COL name VAL jorge garcía	1
COL name VAL jorge sharada garcía	COL name VAL jorge garcía	1
COL name VAL hans tebey aune	COL name VAL hans aune	1
COL name VAL aurelio albert archinti	COL name VAL aurelio archinti	1
COL name VAL albert thomas sambi lokonga	COL name VAL albert sambi lokonga	1
COL name VAL jean-claude richard clari	COL name VAL jean-claude clari	1
COL name VAL delia francisco valeri	COL name VAL delia valeri	1
COL name VAL delia ronny valeri	COL name VAL delia valeri	1
COL name VAL delia adam valeri	COL name VAL delia valeri	1
COL name VAL maria marcos echezarreta	COL name VAL maria echezarreta	1
COL name VAL maria ali echezarreta	COL name VAL maria echezarreta	1
COL name VAL ivan jill galar	COL name VAL ivan galar	1
COL name VAL ivan robert galar	COL name VAL ivan galar	1
COL name VAL pat h. le paulmier	COL name VAL pat le paulmier	1
COL name VAL pat jorunn le paulmier	COL name VAL pat le paulmier	1
COL name VAL marcel whitney flückiger	COL name VAL marcel flückiger	1
COL name VAL heinz maria lüdi	COL name VAL heinz lüdi	1
COL name VAL chris yohanan christenson	COL name VAL chris christenson	1
COL name VAL marguerite ray sechehaye	COL name VAL marguerite sechehaye	1
COL name VAL marguerite marguerite sechehaye	COL name VAL marguerite sechehaye	1
COL name VAL marguerite norman sechehaye	COL name VAL marguerite sechehaye	1
COL name VAL rené mark gillard	COL name VAL rené gillard	1
COL name VAL domenico floyd pozzoni	COL name VAL domenico pozzoni	1
COL name VAL jostein david gundersen	COL name VAL jostein gundersen	1
COL name VAL miriam catherine pucci	COL name VAL miriam pucci	1
COL name VAL michele ann rossi	COL name VAL michele rossi	1
COL name VAL jeroen ruth van den broeck	COL name VAL jeroen van den broeck	1
COL name VAL markus florence wüst	COL name VAL markus wüst	1
COL name VAL stefano maria merlino	COL name VAL stefano merlino	1
COL name VAL stefano leslie merlino	COL name VAL stefano merlino	1
COL name VAL stefano mahmoud merlino	COL name VAL stefano merlino	1
COL name VAL mickaël richard tırpan	COL name VAL mickaël tırpan	1
COL name VAL mickaël james tırpan	COL name VAL mickaël tırpan	1
COL name VAL maría william barja	COL name VAL maría barja	1
COL name VAL maría federico romay	COL name VAL maría romay	1
COL name VAL josé manuel moira gutiérrez	COL name VAL josé manuel gutiérrez	1
COL name VAL josé manuel angelica gutiérrez	COL name VAL josé manuel gutiérrez	1
COL name VAL isabel todd rodríguez	COL name VAL isabel rodríguez	1
COL name VAL henry celestino vollmer	COL name VAL henry vollmer	1
COL name VAL john josé luis schutz	COL name VAL john schutz	1
COL name VAL cristina steven barja	COL name VAL cristina barja	1
COL name VAL cristina gus romay	COL name VAL cristina romay	1
COL name VAL pasqualina william sarro	COL name VAL pasqualina sarro	1
COL name VAL pasqualina henry sarro	COL name VAL pasqualina sarro	1
COL name VAL pasqualina harrison sarro	COL name VAL pasqualina sarro	1
COL name VAL pasqualina toni sarro	COL name VAL pasqualina sarro	1
COL name VAL johan john bollen	COL name VAL johan bollen	1
COL name VAL johan william bollen	COL name VAL johan bollen	1
COL name VAL johan yossi bollen	COL name VAL johan bollen	1
COL name VAL johan joseph bollen	COL name VAL johan bollen	1
COL name VAL johan susannah bollen	COL name VAL johan bollen	1
COL name VAL johan álvaro bollen	COL name VAL johan bollen	1
COL name VAL john john granrud	COL name VAL john granrud	1
COL name VAL john elijah granrud	COL name VAL john granrud	1
COL name VAL gabriele maria gresta	COL name VAL gabriele gresta	1
COL name VAL gabriele yani gresta	COL name VAL gabriele gresta	1
COL name VAL manuel aurora martos	COL name VAL manuel martos	1
COL name VAL manuel kari parra	COL name VAL manuel parra	1
COL name VAL nilde john baracchi	COL name VAL nilde baracchi	1
COL name VAL frantz mario hofmann	COL name VAL frantz hofmann	1
COL name VAL lorena marc villa	COL name VAL lorena villa	1
COL name VAL andré ernest verdeil	COL name VAL andré verdeil	1
COL name VAL markus bryan nüssli	COL name VAL markus nüssli	1
COL name VAL tom james pietermaat	COL name VAL tom pietermaat	1
COL name VAL giovanni abdullah bianchi	COL name VAL giovanni bianchi	1
COL name VAL rudolf israel keller	COL name VAL rudolf keller	1
COL name VAL f. mindy froment	COL name VAL f. froment	1
COL name VAL gilbert selçuk froment	COL name VAL gilbert froment	1
COL name VAL f. michael froment	COL name VAL f. froment	1
COL name VAL gilbert david froment	COL name VAL gilbert froment	1
COL name VAL jean tony neuhaus	COL name VAL jean neuhaus	1
COL name VAL carolina alessandro wolters	COL name VAL carolina wolters	1
COL name VAL álvaro jeanne herreros	COL name VAL álvaro herreros	1
COL name VAL álvaro jesse herreros	COL name VAL álvaro herreros	1
COL name VAL julián michael martínez	COL name VAL julián martínez	1
COL name VAL roberto chris encinas	COL name VAL roberto encinas	1
COL name VAL ruedi ignacio keller	COL name VAL ruedi keller	1
COL name VAL chris glenn van puyvelde	COL name VAL chris van puyvelde	1
COL name VAL bernhard dave müller	COL name VAL bernhard müller	1
COL name VAL miguel ángel frances rubio	COL name VAL miguel ángel rubio	1
COL name VAL modesto jean romero	COL name VAL modesto romero	1
COL name VAL chloé russell van de velde	COL name VAL chloé van de velde	1
COL name VAL chloé ángeles van de velde	COL name VAL chloé van de velde	1
COL name VAL chloé dan van de velde	COL name VAL chloé van de velde	1
COL name VAL joana lucas garcía	COL name VAL joana garcía	1
COL name VAL david mark campos	COL name VAL david campos	1
COL name VAL zeno hossein moser	COL name VAL zeno moser	1
COL name VAL dominic aydemir pozzoni	COL name VAL dominic pozzoni	1
COL name VAL domingo thomas campos	COL name VAL domingo campos	1
COL name VAL jørn frank stubberud	COL name VAL jørn stubberud	1
COL name VAL jürg bjørn wegelin	COL name VAL jürg wegelin	1
COL name VAL willy jamal schäfer	COL name VAL willy schäfer	1
COL name VAL filippo fritz rusuti	COL name VAL filippo rusuti	1
COL name VAL filippo e. rusuti	COL name VAL filippo rusuti	1
COL name VAL filippo michael rusuti	COL name VAL filippo rusuti	1
COL name VAL filippo brandon rusuti	COL name VAL filippo rusuti	1
COL name VAL filippo john rusuti	COL name VAL filippo rusuti	1
COL name VAL filippo gio rusuti	COL name VAL filippo rusuti	1
COL name VAL filippo ole rusuti	COL name VAL filippo rusuti	1
COL name VAL belisario saray acquaviva	COL name VAL belisario acquaviva	1
COL name VAL antonio arnoud gandini	COL name VAL antonio gandini	1
COL name VAL paolo diego roero	COL name VAL paolo roero	1
COL name VAL vincenzo paul roero	COL name VAL vincenzo roero	1
COL name VAL riccardo dean grassetti	COL name VAL riccardo grassetti	1
COL name VAL fritz renee schäublin	COL name VAL fritz schäublin	1
COL name VAL walter joseph dürst	COL name VAL walter dürst	1
COL name VAL üli randolph hofmann	COL name VAL üli hofmann	1
COL name VAL henry mike negretti	COL name VAL henry negretti	1
COL name VAL henry sean negretti	COL name VAL henry negretti	1
COL name VAL henry james negretti	COL name VAL henry negretti	1
COL name VAL celestino blanche pancheri	COL name VAL celestino pancheri	1
COL name VAL rené elizabeth deck	COL name VAL rené deck	1
COL name VAL rené dustin bader	COL name VAL rené bader	1
COL name VAL alessandro odessa benassi	COL name VAL alessandro benassi	1
COL name VAL alessandro giordano benassi	COL name VAL alessandro benassi	1
COL name VAL francesco marcos barbieri	COL name VAL francesco barbieri	1
COL name VAL francesco alan barbieri	COL name VAL francesco barbieri	1
COL name VAL francesco ricky barbieri	COL name VAL francesco barbieri	1
COL name VAL francesco thomas barbieri	COL name VAL francesco barbieri	1
COL name VAL francesco henry barbieri	COL name VAL francesco barbieri	1
COL name VAL francesco christian barbieri	COL name VAL francesco barbieri	1
COL name VAL francesco alvina barbieri	COL name VAL francesco barbieri	1
COL name VAL edwin lisa bryant	COL name VAL edwin bryant	1
COL name VAL edwin john bryant	COL name VAL edwin bryant	1
COL name VAL edwin melis bryant	COL name VAL edwin bryant	1
COL name VAL marius michael larsen	COL name VAL marius larsen	1
COL name VAL kristoffer henning klaesson	COL name VAL kristoffer klaesson	1
COL name VAL catherine joan verleysen	COL name VAL catherine verleysen	1
COL name VAL alfredo andreas fioravanti	COL name VAL alfredo fioravanti	1
COL name VAL andreas dave ton	COL name VAL andreas ton	1
COL name VAL ronald shun de sousa	COL name VAL ronald de sousa	1
COL name VAL felix harry myhre	COL name VAL felix myhre	1
COL name VAL therese jennifer åsland	COL name VAL therese åsland	1
COL name VAL jésus michael barreda	COL name VAL jésus barreda	1
COL name VAL jésus john barreda	COL name VAL jésus barreda	1
COL name VAL yossi mercedes hadar	COL name VAL yossi hadar	1
COL name VAL andy frank ton	COL name VAL andy ton	1
COL name VAL maria andré barreda	COL name VAL maria barreda	1
COL name VAL maria richard barreda	COL name VAL maria barreda	1
COL name VAL karl charles kälin	COL name VAL karl kälin	1
COL name VAL patrick michael bühlmann	COL name VAL patrick bühlmann	1
COL name VAL manuel cédric fernández	COL name VAL manuel fernández	1
COL name VAL tomás ivan fernández	COL name VAL tomás fernández	1
COL name VAL élisabeth douglas duparc	COL name VAL élisabeth duparc	1
COL name VAL justin samantha vulliamy	COL name VAL justin vulliamy	1
COL name VAL bettina rebecca kühn	COL name VAL bettina kühn	1
COL name VAL lars belinda schjetne	COL name VAL lars schjetne	1
COL name VAL lars jacob schjetne	COL name VAL lars schjetne	1
COL name VAL lars anna schjetne	COL name VAL lars schjetne	1
COL name VAL jakob maury tromsdal	COL name VAL jakob tromsdal	1
COL name VAL jakob rené tromsdal	COL name VAL jakob tromsdal	1
COL name VAL rikke manuel nygard	COL name VAL rikke nygard	1
COL name VAL rikke thomas bogetveit	COL name VAL rikke bogetveit	1
COL name VAL gabrielle h. lie	COL name VAL gabrielle lie	1
COL name VAL gabrielle liz lie	COL name VAL gabrielle lie	1
COL name VAL mia michael huse	COL name VAL mia huse	1
COL name VAL guido bente pizarro	COL name VAL guido pizarro	1
COL name VAL alexandre heidi crépet	COL name VAL alexandre crépet	1
COL name VAL michelangelo elizabeth di pietro	COL name VAL michelangelo di pietro	1
COL name VAL michelangelo hillel di pietro	COL name VAL michelangelo di pietro	1
COL name VAL michelangelo simone di pietro	COL name VAL michelangelo di pietro	1
COL name VAL michelangelo christopher di pietro	COL name VAL michelangelo di pietro	1
COL name VAL pietro maria adami	COL name VAL pietro adami	1
COL name VAL diego daniel da silva	COL name VAL diego da silva	1
COL name VAL diego susan giaretta	COL name VAL diego giaretta	1
COL name VAL erwan karina käser	COL name VAL erwan käser	1
COL name VAL philippe thomas fauchet	COL name VAL philippe fauchet	1
COL name VAL max david fauchet	COL name VAL max fauchet	1
COL name VAL philippe lucero fauchet	COL name VAL philippe fauchet	1
COL name VAL max didier fauchet	COL name VAL max fauchet	1
COL name VAL kim-joy linda hewlett	COL name VAL kim-joy hewlett	1
COL name VAL kim-joy eysteinn hewlett	COL name VAL kim-joy hewlett	1
COL name VAL klara francis sporsem	COL name VAL klara sporsem	1
COL name VAL friedrich samuel sustris	COL name VAL friedrich sustris	1
COL name VAL friedrich camillo sustris	COL name VAL friedrich sustris	1
COL name VAL friedrich david sustris	COL name VAL friedrich sustris	1
COL name VAL friedrich katie sustris	COL name VAL friedrich sustris	1
COL name VAL friedrich chris sustris	COL name VAL friedrich sustris	1
COL name VAL friedrich julius sustris	COL name VAL friedrich sustris	1
COL name VAL friedrich adi sustris	COL name VAL friedrich sustris	1
COL name VAL friedrich adrian sustris	COL name VAL friedrich sustris	1
COL name VAL friedrich stephen sustris	COL name VAL friedrich sustris	1
COL name VAL friedrich paul sustris	COL name VAL friedrich sustris	1
COL name VAL friedrich john sustris	COL name VAL friedrich sustris	1
COL name VAL friedrich billy sustris	COL name VAL friedrich sustris	1
COL name VAL friedrich william sustris	COL name VAL friedrich sustris	1
COL name VAL friedrich katharine sustris	COL name VAL friedrich sustris	1
COL name VAL friedrich joseph sustris	COL name VAL friedrich sustris	1
COL name VAL friedrich cory sustris	COL name VAL friedrich sustris	1
COL name VAL friedrich jens sustris	COL name VAL friedrich sustris	1
COL name VAL friedrich tracey sustris	COL name VAL friedrich sustris	1
COL name VAL friedrich john sustris	COL name VAL friedrich sustris	1
COL name VAL friedrich leon sustris	COL name VAL friedrich sustris	1
COL name VAL peter ken müller	COL name VAL peter müller	1
COL name VAL blanche david charlet	COL name VAL blanche charlet	1
COL name VAL valentine mary charlet	COL name VAL valentine charlet	1
COL name VAL carl antonio colpaert	COL name VAL carl colpaert	1
COL name VAL tancrède ivan dumas	COL name VAL tancrède dumas	1
COL name VAL tancrède nasri dumas	COL name VAL tancrède dumas	1
COL name VAL tancrède g. dumas	COL name VAL tancrède dumas	1
COL name VAL tancrède ruth dumas	COL name VAL tancrède dumas	1
COL name VAL tancrède jésus dumas	COL name VAL tancrède dumas	1
COL name VAL nico nicholas brüngger	COL name VAL nico brüngger	1
COL name VAL nico ali brüngger	COL name VAL nico brüngger	1
COL name VAL gregory aaron wüthrich	COL name VAL gregory wüthrich	1
COL name VAL arthur scott varney	COL name VAL arthur varney	1
COL name VAL arthur norma varney	COL name VAL arthur varney	1
COL name VAL gaetano josé luis mignani	COL name VAL gaetano mignani	1
COL name VAL heidi petra ellingsen	COL name VAL heidi ellingsen	1
COL name VAL frode alondra hegland	COL name VAL frode hegland	1
COL name VAL alexander frederick hegland	COL name VAL alexander hegland	1
COL name VAL agustín elden garcía	COL name VAL agustín garcía	1
COL name VAL rodrigo víctor manuel de borja	COL name VAL rodrigo de borja	1
COL name VAL julián linda lópez	COL name VAL julián lópez	1
COL name VAL julián janet lópez	COL name VAL julián lópez	1
COL name VAL otto kathryn bühler	COL name VAL otto bühler	1
COL name VAL otto elan bühler	COL name VAL otto bühler	1
COL name VAL otto clemens schläpfer	COL name VAL otto schläpfer	1
COL name VAL ralph joyce rüegg	COL name VAL ralph rüegg	1
COL name VAL andré anthony niederhäuser	COL name VAL andré niederhäuser	1
COL name VAL valentina arghavan bosetti	COL name VAL valentina bosetti	1
COL name VAL umberto stephen romano	COL name VAL umberto romano	1
COL name VAL leonarda ehud casiraghi	COL name VAL leonarda casiraghi	1
COL name VAL george melissa molteno	COL name VAL george molteno	1
COL name VAL george mohamed molteno	COL name VAL george molteno	1
COL name VAL gianfranco henry felli	COL name VAL gianfranco felli	1
COL name VAL eva cheyenne rønning	COL name VAL eva rønning	1
COL name VAL eva reggie fodor	COL name VAL eva fodor	1
COL name VAL gret arghavan mann	COL name VAL gret mann	1
COL name VAL gret joshua moser	COL name VAL gret moser	1
COL name VAL jorunn lucas buckley	COL name VAL jorunn buckley	1
COL name VAL jorunn friedrich buckley	COL name VAL jorunn buckley	1
COL name VAL jorunn cato buckley	COL name VAL jorunn buckley	1
COL name VAL joan michael massagué	COL name VAL joan massagué	1
COL name VAL joan cali massagué	COL name VAL joan massagué	1
COL name VAL joan darold massagué	COL name VAL joan massagué	1
COL name VAL joan krystyna massagué	COL name VAL joan massagué	1
COL name VAL david timothy rodrigo	COL name VAL david rodrigo	1
COL name VAL miguel ángel rafaela araújo iglesias	COL name VAL miguel ángel araújo iglesias	1
COL name VAL josé manuel david egea	COL name VAL josé manuel egea	1
COL name VAL joaquín john novoa	COL name VAL joaquín novoa	1
COL name VAL rodolphe adrian cuendet	COL name VAL rodolphe cuendet	1
COL name VAL silvan raymond büchli	COL name VAL silvan büchli	1
COL name VAL henry carol müller	COL name VAL henry müller	1
COL name VAL leo alfred pescarolo	COL name VAL leo pescarolo	1
COL name VAL dany turki da silva	COL name VAL dany da silva	1
COL name VAL petra william walczewski	COL name VAL petra walczewski	1
COL name VAL marie alexander aubert	COL name VAL marie aubert	1
COL name VAL mercia norm harrison	COL name VAL mercia harrison	1
COL name VAL martin levi tschudy	COL name VAL martin tschudy	1
COL name VAL martin james tschudi	COL name VAL martin tschudi	1
COL name VAL mercia edgeworth tinker	COL name VAL mercia tinker	1
COL name VAL josé mary santiago concha	COL name VAL josé santiago concha	1
COL name VAL antonio lisa jiménez	COL name VAL antonio jiménez	1
COL name VAL nathaniel herbert andré	COL name VAL nathaniel andré	1
COL name VAL carlos mary arroyo	COL name VAL carlos arroyo	1
COL name VAL adolfo john prada	COL name VAL adolfo prada	1
COL name VAL julien vasily livi	COL name VAL julien livi	1
COL name VAL manfredi rana lefebvre	COL name VAL manfredi lefebvre	1
COL name VAL manfredi james lefebvre	COL name VAL manfredi lefebvre	1
COL name VAL manfredi william lefebvre	COL name VAL manfredi lefebvre	1
COL name VAL elsa esnoult de michael je taime penelope horváth	COL name VAL elsa esnoult de michael je taime horváth	1
COL name VAL elsa esnoult de michael je taime lance horváth	COL name VAL elsa esnoult de michael je taime horváth	1
COL name VAL markus charles bösiger	COL name VAL markus bösiger	1
COL name VAL conrad gül buff	COL name VAL conrad buff	1
COL name VAL conrad eduardo buff	COL name VAL conrad buff	1
COL name VAL joão andrea oliveira	COL name VAL joão oliveira	1
COL name VAL e. heidi garcin	COL name VAL e. garcin	1
COL name VAL e. miranda garcin	COL name VAL e. garcin	1
COL name VAL francine richard lacqua	COL name VAL francine lacqua	1
COL name VAL kat bill arney	COL name VAL kat arney	1
COL name VAL sarah juan suphellen	COL name VAL sarah suphellen	1
COL name VAL sarah thora suphellen	COL name VAL sarah suphellen	1
COL name VAL michael joaquín wollan	COL name VAL michael wollan	1
COL name VAL lars amalie olson	COL name VAL lars olson	1
COL name VAL jens krayem opsahl	COL name VAL jens opsahl	1
COL name VAL john john oppegaard	COL name VAL john oppegaard	1
COL name VAL auguste ken garcin	COL name VAL auguste garcin	1
COL name VAL auguste peyman garcin	COL name VAL auguste garcin	1
COL name VAL josé mordechai espelius	COL name VAL josé espelius	1
