COL name VAL the sweet factory orders	COL name VAL sea sweet	0
COL name VAL the council for the rapprochement of islamic theological schools	COL name VAL the world assembly for the rapprochement of islamic schools	0
COL name VAL the beirut airport presidency	COL name VAL the beirut international airport presidency	1
COL name VAL art lounge	COL name VAL u lounge bar	0
COL name VAL chaldean sect	COL name VAL the chaldean diocese	0
COL name VAL niamh fleming farrell literature	COL name VAL niamh fleming farrell celebratory	1
COL name VAL usa gymnastics	COL name VAL the international gymnastics federation	0
COL name VAL universal music publishing group	COL name VAL universal music group	1
COL name VAL the bachir gemayel foundation	COL name VAL bachir gemayel academy	0
COL name VAL university of oklahoma	COL name VAL the oklahoma department of corrections	0
COL name VAL the big blue association	COL name VAL the operation big blue association	1
COL name VAL st charles city center	COL name VAL charles saad school	0
COL name VAL fidelity investments worldwide	COL name VAL fidelity investments	1
COL name VAL match capital	COL name VAL matching capital	0
COL name VAL dalberg global development advisors	COL name VAL global risk advisors	0
COL name VAL the chamber of delegates	COL name VAL the council of delegates	0
COL name VAL nidaa al_watan naharnet	COL name VAL nida al_watan	1
COL name VAL jamal trust bank	COL name VAL jammal bank	1
COL name VAL capital area interfaith friends	COL name VAL android 8 1 oreo	0
COL name VAL travel and leisure	COL name VAL travel leisure	1
COL name VAL the sultan company	COL name VAL the sukomi company	0
COL name VAL tele lumiere group	COL name VAL tele lumiere	1
COL name VAL leil productions	COL name VAL abbout productions	0
COL name VAL the united arab emirates ministry of information and tourism	COL name VAL information and tourism ministries	0
COL name VAL lf party	COL name VAL the leave party	0
COL name VAL the bristol group	COL name VAL first bristol group	1
COL name VAL the muslim students association of the united states and canada	COL name VAL statistics canada	0
COL name VAL university of texas southwestern medical center	COL name VAL ut southwestern medical center	0
COL name VAL tele lumiere noursat	COL name VAL tele lumiere	1
COL name VAL maqamat org	COL name VAL maqamat dance house	0
COL name VAL al_kalima online	COL name VAL uighur online	0
COL name VAL directorate general of urban planning	COL name VAL the directorate general of urban planning	1
COL name VAL security and stability support fund	COL name VAL conflict stability security fund	1
COL name VAL the maan together campaign for civil peace	COL name VAL together for a sustainable society	0
COL name VAL vaccines pharma and manufacturers	COL name VAL immunization and vaccines development programme	0
COL name VAL the lebanese electricity corporation	COL name VAL the electricity corporation	1
COL name VAL purple art production	COL name VAL the union of paraplegics	0
COL name VAL geos solutions llc	COL name VAL neos geosolutions	0
COL name VAL the florence police department	COL name VAL the seattle police department	0
COL name VAL jinsiyati karamati	COL name VAL m gourmet	0
COL name VAL the medicines patent pool	COL name VAL medicines patent pool	1
COL name VAL the episcopal commission for the pastoral care	COL name VAL the episcopal commission for family and life	0
COL name VAL le palais de la femme	COL name VAL 103 fm	0
COL name VAL condoto company	COL name VAL safa quintet	0
COL name VAL kuwaiti airways	COL name VAL the kuwait airways	1
COL name VAL the u s drug enforcement agency	COL name VAL u s drug enforcement agency	1
COL name VAL petroleum alliance nna	COL name VAL the petroleum alliance	1
COL name VAL the sham al_islam movement	COL name VAL sham al_islam	1
COL name VAL rose acre farms	COL name VAL formosa tv	0
COL name VAL a group of governmental experts	COL name VAL the u n group of governmental experts	0
COL name VAL al_qaeda in the maghreb	COL name VAL al_qaida in the islamic magreb	1
COL name VAL immunization and essential drugs program	COL name VAL amnesty nna	0
COL name VAL the starch foundation	COL name VAL the arab british centre starch foundation	0
COL name VAL malhama tactical	COL name VAL the tactical operations center	0
COL name VAL the mu taz and rada sawwaf arabic comics initiative	COL name VAL rada sawwaf arabic comics initiative	1
COL name VAL the free cause party	COL name VAL wcbs 880	0
COL name VAL the advice for small business programme	COL name VAL advice for small business programme	1
COL name VAL the federal university of bahia	COL name VAL the university of bejaia	1
COL name VAL conde nast traveler	COL name VAL conde naste traveler	1
COL name VAL lake braddock secondary school	COL name VAL social protection	0
COL name VAL the supreme audit	COL name VAL asean supreme audit institutions	0
COL name VAL the global campaign for equal nationality rights	COL name VAL the human rights campaign	0
COL name VAL airforce intelligence	COL name VAL an army intelligence force	0
COL name VAL panorama des cinemas du maghreb et du moyen orient	COL name VAL panorama foundation	0
COL name VAL bmb calix	COL name VAL pmp 663	0
COL name VAL the lebanese meteorological service	COL name VAL the meteorological office	0
COL name VAL london stock exchange	COL name VAL the london open exchange	0
COL name VAL the virginia state police	COL name VAL virginia state police	1
COL name VAL word bank	COL name VAL world banks	0
COL name VAL synchrotron bessy i	COL name VAL synchrony financial	0
COL name VAL hamra gallery zamaan	COL name VAL gallery semaan	0
COL name VAL thinkplay ltd	COL name VAL 6 led	0
COL name VAL the american friends of ateret cohanim	COL name VAL ateret cohanim	0
COL name VAL the stars academy	COL name VAL the stars academy for sports	1
COL name VAL safe borders project	COL name VAL the save the night project	0
COL name VAL the feb 17 martyrs brigade	COL name VAL the jusiyah martyrs brigade	0
COL name VAL the futures company	COL name VAL phillip futures	0
COL name VAL labor friends of israel	COL name VAL conservative friends of israel	1
COL name VAL fath al_islam	COL name VAL fath el_islam	1
COL name VAL saint jude	COL name VAL jeita nna	0
COL name VAL jahabat al_nusra	COL name VAL jebhat al_nusra	0
COL name VAL the council of senior scholars	COL name VAL the council of senior religious scholars	1
COL name VAL american suzuki motor corp	COL name VAL suzuki shutters	0
COL name VAL arabesque press	COL name VAL airbus se	0
COL name VAL ngo ahla fawda	COL name VAL ahla fawda	1
COL name VAL shebab al_umma	COL name VAL shabab al_umma	1
COL name VAL the lebanese south korean friendship committee	COL name VAL the south korean army	0
COL name VAL the arab institute for women	COL name VAL the arab institute of women	1
COL name VAL so beirut	COL name VAL li beirut	0
COL name VAL the batroun qada	COL name VAL the batroun caza	0
COL name VAL tejarat almas mobin holding	COL name VAL the etemad tejarate pars co	0
COL name VAL rio tinto group	COL name VAL rio tinto	1
COL name VAL real estate weekly	COL name VAL us weekly	0
COL name VAL government debt defeasance fund	COL name VAL depot vente	0
COL name VAL wan ifra	COL name VAL wan efra	1
COL name VAL the union for the sake of lebanon	COL name VAL the aikido union of lebanon	1
COL name VAL p s p	COL name VAL f s p	0
COL name VAL the lebanese mexican house	COL name VAL the lebanese mexican cultural institute	0
COL name VAL heart of jesus hospital	COL name VAL the catholic university of the heart of jesus	0
COL name VAL beit atfal assamoud	COL name VAL beit atfal assumoud	1
COL name VAL ira nna	COL name VAL nusra nna	0
COL name VAL the lancaster eden bay hotel	COL name VAL lancaster plaza hotel	0
COL name VAL neptune p2p group	COL name VAL alsarah and the nubatones	0
COL name VAL the association to advance collegiate schools of business aacsb international	COL name VAL the united world collegedilijan	0
COL name VAL the amjad secondary school	COL name VAL amchit secondary school	0
COL name VAL truth and reconciliation commission	COL name VAL a truth and dignity commission	0
COL name VAL global fund for community engagement and resilience	COL name VAL the global community engagement and resilience fund	1
COL name VAL battle groups	COL name VAL brattle group	1
COL name VAL the italian institute of hydrography	COL name VAL hydrography dept	0
COL name VAL border police	COL name VAL cyber police	0
COL name VAL dar al_handasah shair partners	COL name VAL shair and partners	0
COL name VAL taste flavors	COL name VAL taste and flavors magazine	1
COL name VAL the alliance of mediterranean news agencies	COL name VAL the association of mediterranean news agencies	1
COL name VAL national bureau for family and population	COL name VAL the national bureau for family and population	1
COL name VAL al_youm news	COL name VAL shia islam	0
COL name VAL the general authority for investment and privatization in libya	COL name VAL the privatization and investment board of libya	0
COL name VAL real madridchelsea	COL name VAL real madrid fc	0
COL name VAL the irish lebanese cultural foundation	COL name VAL the lebanese intellectual foundation	0
COL name VAL antoine hakim joailliers	COL name VAL the jewelers syndicate	0
COL name VAL bachpan bachao andolan	COL name VAL afir beekeeping and nature discovery center	0
COL name VAL rheinische post	COL name VAL la posta	0
COL name VAL the league of lebanese university professors	COL name VAL the league of lu professors	0
COL name VAL conference of beirut and the coast	COL name VAL beirut conference	0
COL name VAL shabab alghazieh	COL name VAL shbib nna	0
COL name VAL the st george yacht club	COL name VAL the st george hotel and yacht club	1
COL name VAL the sovereign council	COL name VAL the rally for sovereignty	0
COL name VAL non aligned summit	COL name VAL non aligned countries foreign ministers	0
COL name VAL the dubai financial market exchange	COL name VAL the dubai financial market stock exchange	1
COL name VAL quatour musique del tempo	COL name VAL musique del tempo	1
COL name VAL the musee du quai branly	COL name VAL brunel university	0
COL name VAL the directorate general for urban planning	COL name VAL the general directorate of urban planning	1
COL name VAL internet corporation for assigned names and numbers	COL name VAL the internet corporation for assigned names and numbers	1
COL name VAL jobs in basra	COL name VAL jbs sa	0
COL name VAL the major cities chiefs association	COL name VAL major county sheriff association	0
COL name VAL st teresa christian youth group	COL name VAL the white trees	0
COL name VAL know nothing party	COL name VAL nottingham forest	0
COL name VAL the committee on commerce science and transportation	COL name VAL the economy commerce and industry committee	0
COL name VAL the council of chairmen of franco	COL name VAL chairman board of investment	0
COL name VAL rassemblement democratique des femmes	COL name VAL the rassemblement constitutionnel democratique	0
COL name VAL kbl richelieu banque privee	COL name VAL kbl richelieu	0
COL name VAL ashrae chapter	COL name VAL the ashrae lebanon chapter	1
COL name VAL water management international pte ltd	COL name VAL iships management pte ltd	0
COL name VAL bctc company	COL name VAL admic company	0
COL name VAL akkar dinniyyeh	COL name VAL seer dinniyyeh	0
COL name VAL bank 1	COL name VAL bank b	0
COL name VAL cnn freedom project	COL name VAL freedom right project	0
COL name VAL the lebanese faith energy	COL name VAL the lebanese faith energy association	1
COL name VAL champs fund for young hearts and athletes health	COL name VAL champs fund	0
COL name VAL angry monkey	COL name VAL the angry monkey	1
COL name VAL vfs global	COL name VAL the fafs dean office	0
COL name VAL architects for change	COL name VAL students for change	0
COL name VAL pick a toy	COL name VAL the big 12	0
COL name VAL the office of foreign assets control	COL name VAL office of foreign asset control	1
COL name VAL the renaissance and virtue party	COL name VAL renaissance partnership	0
COL name VAL barbados today	COL name VAL the barbados police service	0
COL name VAL saraya al_	COL name VAL saraya al_sham	0
COL name VAL the armed conflict location event project	COL name VAL the armed conflict location and event data project	1
COL name VAL the uk times	COL name VAL ny times	0
COL name VAL fairfax media	COL name VAL inova fairfax hospital	0
COL name VAL the national campaign for the protection of migratory birds	COL name VAL the national campaign for the protection of the litani river	0
COL name VAL research in motion	COL name VAL art in motion	0
COL name VAL the fund for the rescue of the people of israel	COL name VAL the new israel fund	0
COL name VAL federation of american scientists	COL name VAL scientific american	0
COL name VAL global center for the responsibility to protect	COL name VAL the coronavirus global response	0
COL name VAL the lebanese insurance association	COL name VAL the lebanese microfinance association	0
COL name VAL pierre fabre	COL name VAL faber faber	0
COL name VAL sovereignty first	COL name VAL the sovereign council	0
COL name VAL fbme bank	COL name VAL fbme bank ltd	1
COL name VAL the citizen reception office	COL name VAL gashora reception centre	0
COL name VAL baalbeck hermel gov	COL name VAL baalbek hermel choice	0
COL name VAL the chinese visa application service center	COL name VAL schengen visa application center	0
COL name VAL the lebanese sync company	COL name VAL the lebanese poultry company	0
COL name VAL the national commission to reform information and communication	COL name VAL the national development and reform commission	0
COL name VAL eastern med	COL name VAL the australian u n	0
COL name VAL the libyan shield force	COL name VAL the libya shield force	1
COL name VAL the danish agency of culture	COL name VAL the danish cultural institute	0
COL name VAL italian navy	COL name VAL the new atlanticist	0
COL name VAL cis buro	COL name VAL wcbs 880	0
COL name VAL khiyam social cultural club	COL name VAL the social club	0
COL name VAL sueddeutsche zeitung	COL name VAL suddeutsche zeitung	1
COL name VAL bank al_	COL name VAL bank a	0
COL name VAL quds supporting	COL name VAL dick sporting goods	0
COL name VAL the village voice	COL name VAL village voice	1
COL name VAL together we go company	COL name VAL together for life	0
COL name VAL world monuments fund	COL name VAL the world monuments fund	1
COL name VAL left democratic	COL name VAL the federation of the democratic left	1
COL name VAL the shura committee	COL name VAL the united shariah committee	0
COL name VAL salafist al_nour	COL name VAL the salafist al_nour party	1
COL name VAL lancaster university	COL name VAL aer lingus	0
COL name VAL national health systems resource center	COL name VAL health systems global	0
COL name VAL research in motion ltd	COL name VAL research in motion	1
COL name VAL a cultural heritage and urban development project	COL name VAL the cultural heritage and urban development project	1
COL name VAL visit lebanon	COL name VAL elle fiesta	0
COL name VAL this community policing station	COL name VAL community policing	0
COL name VAL princeton university press	COL name VAL the universite de paris	0
COL name VAL zuwwar al_imam ali al_reda	COL name VAL zuwwar alimam ali al_reda	1
COL name VAL nippon television	COL name VAL dragon television	0
COL name VAL the paris 1 university pantheon sorbonne	COL name VAL pantheon sorbonne	0
COL name VAL all4 syria	COL name VAL suria al_	0
COL name VAL the military institution	COL name VAL the u s military	0
COL name VAL the ideas factory	COL name VAL ideas factory	1
COL name VAL petroleum and natural gas of india	COL name VAL anti eu	0
COL name VAL christie dubai	COL name VAL christies dubai	1
COL name VAL msf france	COL name VAL msf nna	0
COL name VAL senior scholars council	COL name VAL the council of senior scholars	1
COL name VAL socialproof security	COL name VAL u s social security	0
COL name VAL embassy of algiers	COL name VAL algerianu n	0
COL name VAL helikon opera	COL name VAL the helikon opera company	1
COL name VAL the front altair	COL name VAL front altair	1
COL name VAL energy and buildings	COL name VAL building energy systems	1
COL name VAL the lebanese association for school safety awareness	COL name VAL the youth association for social awareness	0
COL name VAL the right sector	COL name VAL right sector	1
COL name VAL humanity and inclusion	COL name VAL u n humanitarian and	0
COL name VAL sharjah art foundation	COL name VAL barjeel art foundation	0
COL name VAL deutsche post dhl group	COL name VAL deutsche brse	0
COL name VAL operation big blue association obba	COL name VAL the big blue	0
COL name VAL loeb house	COL name VAL kataeb house	0
COL name VAL current medical research and opinion	COL name VAL the grant research program	0
COL name VAL real madrid camps	COL name VAL real madrid fc	0
COL name VAL the internal displacement monitoring center	COL name VAL disability monitor	0
COL name VAL the supreme islamic committee	COL name VAL the islamic supreme shia council	0
COL name VAL reuters tv	COL name VAL school of rioters	0
COL name VAL 183 reggimento paracadusiti nembo	COL name VAL numbeo com	0
COL name VAL the arab gulf affairs	COL name VAL arabian gulf affairs	0
COL name VAL the nour al_din al_zinki movement	COL name VAL nour al_din al_zinki movement	1
COL name VAL energy and hydraulic resources	COL name VAL public works transportation energy and hydraulic resources house commission	0
COL name VAL shabab al_sahel	COL name VAL shabab el_sahel club	1
COL name VAL texas engineering experiment station	COL name VAL the texas a m engineering experiment station	1
COL name VAL bchamoun specialist hospital	COL name VAL bshamoun hospital	1
COL name VAL the korea electric power corporation	COL name VAL the kyushu electric power co	0
COL name VAL borchardt hume	COL name VAL invesco powershares	0
COL name VAL the salafist al_nour party	COL name VAL the salafist al_nour brigades	0
COL name VAL syndigate media inc	COL name VAL american media inc	0
COL name VAL u s bureau of land management	COL name VAL bureau of ocean energy management	0
COL name VAL representatives against violence organization	COL name VAL media against violence	0
COL name VAL al_hijra wal takfir	COL name VAL takfir wa al_hijra	0
COL name VAL tanmiah chicken	COL name VAL hawa chicken	0
COL name VAL jihad al_binaa institute	COL name VAL jihad al_binaa foundation	0
COL name VAL the lebanese institute for the preparation of educators	COL name VAL the lebanese institute for diving education	0
COL name VAL dynamo moscow	COL name VAL moscow hospital no	0
COL name VAL the fattal group	COL name VAL fadel group	0
COL name VAL the grand cafe	COL name VAL la cave	0
COL name VAL national public radio	COL name VAL israeli public radio	0
COL name VAL pro hizbullah al_akhbar	COL name VAL pro hizbullah al_mayadeen	0
COL name VAL original tours	COL name VAL urgenda foundation	0
COL name VAL un rights council	COL name VAL u n human rights council	0
COL name VAL the zahra school	COL name VAL zahraa school	1
COL name VAL yellow vest	COL name VAL the yellow vests	0
COL name VAL the british ministry of defense for the middle east	COL name VAL the british ministry of defense for middle eastern affairs	0
COL name VAL granatieri di sardegna brigade	COL name VAL la nuova sardegna	0
COL name VAL the business leaders forum	COL name VAL the francophonie business forum	0
COL name VAL the al_azhar al_sharif	COL name VAL the al_azhar al_sheirf	0
COL name VAL subul al_salam	COL name VAL subul al_salam association	1
COL name VAL the japan reading program	COL name VAL the read japan program	0
COL name VAL the franklin and eleanor roosevelt institute	COL name VAL the roosevelt house public policy institute	0
COL name VAL lloyds banking group	COL name VAL lloyds bank	0
COL name VAL jsc novatek	COL name VAL jessica k	0
COL name VAL the ministry for foreign affairs and trade promotion	COL name VAL foreign affairs and trade minister	1
COL name VAL gras savoye assurance	COL name VAL ufa assurances	0
COL name VAL euromed pprd south 2 project	COL name VAL south board	0
COL name VAL fusion gps	COL name VAL studio vision	0
COL name VAL ptt exploration and production company limited	COL name VAL ptt exploration production	1
COL name VAL the talal abu_ghazaleh graduate school of business	COL name VAL stanford graduate school of business	0
COL name VAL thalidomide agency uk	COL name VAL thalidomide uk	1
COL name VAL the filarmonica gioachino rossini orchestra	COL name VAL the filarmonica gioacchino rossini orchestra	1
COL name VAL unicef project	COL name VAL unicef unicef	0
COL name VAL al_kafaat university	COL name VAL universite al_kafaat	1
COL name VAL all 4 syria	COL name VAL saraya al_	0
COL name VAL horsh ehden nature reserve	COL name VAL the ehden cedar reserve	0
COL name VAL the acquisition technology logistics agency	COL name VAL the defense logistics agency	0
COL name VAL the joint warfare centre	COL name VAL the islamic revolutionary guard corps electronic warfare and cyber defense organization	0
COL name VAL the mintz group	COL name VAL 60 minutes	0
COL name VAL the australian army	COL name VAL australian aid	0
COL name VAL u s nuclear fleet	COL name VAL naqoura nna	0
COL name VAL mentor arabia	COL name VAL mentor arabia friends	1
COL name VAL the mim museum	COL name VAL the met museum	0
COL name VAL china north industries group corporation	COL name VAL north and	0
COL name VAL the telecom house commission	COL name VAL nna house commission for media and telecom	1
COL name VAL the romanian radio chamber orchestra	COL name VAL the bucharest radio chamber orchestra	1
COL name VAL economena analytics	COL name VAL strategy analytics	0
COL name VAL hamburg port consulting	COL name VAL hamburg sud	0
COL name VAL prison service	COL name VAL the israel prisons service	1
COL name VAL akademie der kunste	COL name VAL haus der kunst	0
COL name VAL armenian agreement	COL name VAL euromena iii	0
COL name VAL the unified medical bureau	COL name VAL g 7 infighting	0
COL name VAL ensemble mezwej	COL name VAL mezwej ensemble	1
COL name VAL the ndc partnership	COL name VAL the partnership forum	0
COL name VAL baltimore sun	COL name VAL the baltimore gas and electric co	0
COL name VAL islamic awqaf	COL name VAL the islamic awqaf department	1
COL name VAL the nazareth district court	COL name VAL district court	1
COL name VAL the technical institute of scientific and occupational development	COL name VAL the oie scientific and technical department	0
COL name VAL sony pictures	COL name VAL sony pictures entertainment	1
COL name VAL harris interactive agence epoka	COL name VAL harris interactive	0
COL name VAL itimaii tripoli	COL name VAL ijtimaii tripoli	1
COL name VAL vdl 100 3	COL name VAL vdl 93 3	0
COL name VAL district court	COL name VAL the district court of the hague	1
COL name VAL washington office on latin america	COL name VAL the washington office on latin america	1
COL name VAL the syndicate of expert accountants	COL name VAL car expo syndicate	0
COL name VAL the azerbaijani defense ministry	COL name VAL the qatari defense ministry	0
COL name VAL the press emblem campaign	COL name VAL press emblem campaign	1
COL name VAL the speech therapy institute	COL name VAL kaleido therapy	0
COL name VAL jammal bank	COL name VAL jamali nna	0
COL name VAL harakat amal	COL name VAL harakat huqooq	0
COL name VAL the european school survey project on alcohol and other drugs	COL name VAL other press	0
COL name VAL athens university geodynamic institute	COL name VAL the athens geodynamic institute	1
COL name VAL hayat tahrir al_	COL name VAL tahrir al_	1
COL name VAL the arab deterrent force	COL name VAL arab force	1
COL name VAL serta channels huawei	COL name VAL serta channels	1
COL name VAL barcelona process	COL name VAL the barcelona process	1
COL name VAL the congregation of the doctrine of the faith	COL name VAL the congregation for the doctrine of the faith	1
COL name VAL the environment committee in the diocese of sidon	COL name VAL diocese of	0
COL name VAL the cnrs lnoted	COL name VAL the cnrs l h e	0
COL name VAL bayan center	COL name VAL the banna center	0
COL name VAL khmer rouge	COL name VAL le rouge	0
COL name VAL the mashreq party	COL name VAL mashreq hospital	0
COL name VAL the housing ministry	COL name VAL housing ministry	1
COL name VAL nida al_watan	COL name VAL nidaa al_watan naharnet	1
COL name VAL ashrafieh free decision	COL name VAL the free decision bloc	0
COL name VAL the mit imagination computation and expression laboratory	COL name VAL european space imaging	0
COL name VAL the italian senate	COL name VAL the italian navy	0
COL name VAL lu contractual professors committee	COL name VAL the committee of film professionals	0
COL name VAL the autonomous administration of north and east syria	COL name VAL the autonomous self administration of north and east syria	1
COL name VAL the fatah conquest alliance	COL name VAL the fido alliance	0
COL name VAL the federal commerce ministry	COL name VAL ministry of commerce	1
COL name VAL the deuxieme bureau	COL name VAL taksim solidarity	0
COL name VAL the al_nahyan center	COL name VAL kadaya al_nahar	0
COL name VAL the collaborative for leadership and innovation in health systems	COL name VAL health systems global	0
COL name VAL the lancaster plaza hotel	COL name VAL lancaster eden bay hotel	0
COL name VAL the counterterrorism and serious crimes bureau	COL name VAL the serious crimes court	0
COL name VAL the expanded police professional ep2 program	COL name VAL expanded police professionalism	1
COL name VAL the rajaee shahr prison	COL name VAL la roja	0
COL name VAL mei gallery	COL name VAL uffizi gallery	0
COL name VAL sunday market	COL name VAL u n marked	0
COL name VAL the doha clinic hospital	COL name VAL doha two	0
COL name VAL the general directorate of the islamic waqf	COL name VAL the directorate general of islamic endowments	1
COL name VAL ansarul islam	COL name VAL ansaroul islam	1
COL name VAL the syrian electronic army	COL name VAL the saudi electronic army	0
COL name VAL future tv network	COL name VAL sat 7 tv network	0
COL name VAL the international association to combat violence against children	COL name VAL international association to combat violence against	1
COL name VAL social message association	COL name VAL the movement for lebanon the message	0
COL name VAL hope the helpers	COL name VAL halliburton co	0
COL name VAL the university of buenos aires	COL name VAL the buenos aires times	0
COL name VAL the minnesota turkey growers association	COL name VAL the bekaa growers and peasants association	0
COL name VAL mediterranean nna	COL name VAL mediterranean politics	0
COL name VAL the national cybersecurity and communications integration center	COL name VAL supreme council of cyberspace and national cyberspace center	0
COL name VAL falafel sahyoun	COL name VAL mustafa sahyoun falafel	1
COL name VAL souk al_souk	COL name VAL souk al_khan	0
COL name VAL the lebanese american renaissance partnership larp	COL name VAL the lebanese american renaissance partnership association	1
COL name VAL the bureau of ocean energy management	COL name VAL pira energy group	0
COL name VAL ministerial crisis cell	COL name VAL the ministerial crisis cell	1
COL name VAL al_joumhouriya daily	COL name VAL al_joumhoria daily	1
COL name VAL libya central shield	COL name VAL scheld center	1
COL name VAL criminal evidence bureau	COL name VAL criminal evidence	1
COL name VAL war children holland	COL name VAL war child holland	1
COL name VAL the slow factory	COL name VAL the slow food movement	0
COL name VAL arab international society for management technology forum	COL name VAL the arab international society for management technology	1
COL name VAL kyushu electric power co	COL name VAL the tohoku electric power co	1
COL name VAL baff for youth	COL name VAL howa bv	0
COL name VAL lancaster suites	COL name VAL lancaster hotels and suites	1
COL name VAL the international association to combat violence against children	COL name VAL the global partnership to end violence against children	0
COL name VAL the university of nottingham	COL name VAL nottingham forest	0
COL name VAL stanford graduate school of business	COL name VAL the talal abu_ghazaleh graduate school of business	0
COL name VAL the fur free alliance	COL name VAL ver di	0
COL name VAL the ketab and sunna society	COL name VAL anti kdp	0
COL name VAL hawat trading co	COL name VAL the hawat trading co	1
COL name VAL darkside babel theater	COL name VAL babel theater	1
COL name VAL qatar museums	COL name VAL the museums authority	0
COL name VAL aknaf beit al_maqdis	COL name VAL ansar beit al_maqdis	0
COL name VAL the cultural heritage protection treaties section	COL name VAL the heritage protection program	0
COL name VAL blue nile tv	COL name VAL nile tv	1
COL name VAL kelantan fc	COL name VAL kelantan fa	1
COL name VAL the everly brothers	COL name VAL everly brothers	1
COL name VAL bates college	COL name VAL cis college	0
COL name VAL aida cherfan gallery	COL name VAL aida cherfan	1
COL name VAL the heinrich boell foundation	COL name VAL heinrich boll foundation	1
COL name VAL the bernstein program on gulf and energy policy	COL name VAL energy and	0
COL name VAL free officers	COL name VAL efghermes investment	0
COL name VAL euromena iii	COL name VAL mena ii	0
COL name VAL rixos premium tekriova	COL name VAL rixos premium bodrum	0
COL name VAL the league of media graduates	COL name VAL the league of graduates and interns	1
COL name VAL lafayette college	COL name VAL lafayette company	0
COL name VAL publishing house dawawine	COL name VAL dar al_adab publishing house	0
COL name VAL legislative chapter	COL name VAL the legislative party	0
COL name VAL al_marej organic food	COL name VAL al_marej organic farms and food store	1
COL name VAL art lounge	COL name VAL the cedar lounge	0
COL name VAL taste and flavors magazine	COL name VAL taste flavors	1
COL name VAL the us postal service	COL name VAL the postal service	1
COL name VAL safe building alliance	COL name VAL the safe building alliance international	1
COL name VAL the aley municipality	COL name VAL the kabul municipality	0
COL name VAL al_nidaa hospital	COL name VAL al_nidaa al_insani hospital	1
COL name VAL governance security social development	COL name VAL u s social security	0
COL name VAL master chips factory	COL name VAL master chips and poppins	0
COL name VAL kbl monaco private bankers	COL name VAL kbl european private bankers	1
COL name VAL cleary gottlieb steen hamilton	COL name VAL lazard cleary gottlieb steen	1
COL name VAL detroit news	COL name VAL the detroit news	1
COL name VAL the hebrew university of jerusalem faculty of law	COL name VAL partisans of jerusalem	0
COL name VAL aub nna	COL name VAL wto ep	0
COL name VAL freres school	COL name VAL freres college	0
COL name VAL downing street	COL name VAL a twinning programme	0
COL name VAL blue like an orange sustainable capital	COL name VAL orange s a	0
COL name VAL overseas private investment corp	COL name VAL overseas private investment corporation	1
COL name VAL state government trading corporation	COL name VAL government trading corporation	1
COL name VAL strateji menkul degerler as	COL name VAL doctoral studies	0
COL name VAL xinhua nna	COL name VAL zwein nna	0
COL name VAL westminster mortuary	COL name VAL house of wisdom	0
COL name VAL campus of innovation and sportof	COL name VAL usj sports and innovation campus	1
COL name VAL non gcc mena	COL name VAL non gcc arab	0
COL name VAL the turkey cyprus project	COL name VAL turkey cyprus project	1
COL name VAL the ifight pid fund	COL name VAL ifight pid fund	1
COL name VAL the honorary consular corps of lebanon	COL name VAL the consular corps	0
COL name VAL prosperous tripoli	COL name VAL the prosperity party	0
COL name VAL multilateral development	COL name VAL multilateral investment guarantee agency	0
COL name VAL permanent select committee on intelligence	COL name VAL the house of representatives permanent select committee on intelligence	1
COL name VAL startup megaphone	COL name VAL lebanon investment in microfinance	0
COL name VAL the imam khomeini space center	COL name VAL common space	0
COL name VAL ogero syndicate	COL name VAL ogero syndicate union	1
COL name VAL standard and poor	COL name VAL standards and poors	1
COL name VAL the tourism and transportation ministries	COL name VAL information and tourism ministries	1
COL name VAL ain saade	COL name VAL ain saa	0
COL name VAL the commemoration committees of the east giants	COL name VAL the new york giants	0
COL name VAL the international nuremberg principles academy	COL name VAL nuremberg tribunal	0
COL name VAL the qudra programme	COL name VAL the qudra 2 programme	1
COL name VAL the hebrew university	COL name VAL the hebrew university bible project	0
COL name VAL the maison europeenne de la photographie	COL name VAL la maison europeenne de la photographie	1
COL name VAL the milstein program in technology and humanity	COL name VAL u n humanitarian and	0
COL name VAL the edward said conservatory	COL name VAL the edward said national conservatory of music	1
COL name VAL banc ldex	COL name VAL beijingdance ldtx	0
COL name VAL lde conference	COL name VAL london conference	0
COL name VAL hands of hope	COL name VAL the hindustan times	0
COL name VAL the oxygen society for environmental protection	COL name VAL cedar oxygen fund	0
COL name VAL adage capital partners gp llc	COL name VAL gobi partners	0
COL name VAL kataeb house	COL name VAL saifi kataeb central house	0
COL name VAL our lady of balamand patriarchal monastery	COL name VAL the balamand monastery	0
COL name VAL the partnership committee	COL name VAL the partnership forum	0
COL name VAL le souverain	COL name VAL karwan saffron	0
COL name VAL the bureau of ocean energy management	COL name VAL u s bureau of land management	0
COL name VAL the early learning center	COL name VAL the learning center	1
COL name VAL iucn congress	COL name VAL the iucn congress	1
COL name VAL st thomas hospital	COL name VAL st thomas	1
COL name VAL the center for applied research in partnership with the orient	COL name VAL fata research center	0
COL name VAL finnish hockey association	COL name VAL fneish nna	0
COL name VAL the american mideast coalition for democracy	COL name VAL democracy for america	1
COL name VAL the national committee for the activation of rural tourism in lebanon	COL name VAL the ministerial committee for rural development	0
COL name VAL korea electric power corporation	COL name VAL the korea electric power corporation	1
COL name VAL the other russia	COL name VAL the atheer labs	0
COL name VAL layalina cafe	COL name VAL lina cafe	0
COL name VAL syndicat national de l edition	COL name VAL rawiya editions	0
COL name VAL courtesyofhampshirecollege naharnet2016	COL name VAL cl naharnet	0
COL name VAL the juvenile protection office	COL name VAL the union of protection of juveniles	0
COL name VAL the peshmerga of rojava	COL name VAL the federal democratic system of rojava	0
COL name VAL piggly wiggly	COL name VAL the conversation weekly	0
COL name VAL tatweej academy	COL name VAL the tatweej academy for excellence awards	0
COL name VAL the higher ministerial committee	COL name VAL the higher common ministerial committee	1
COL name VAL dalal steel structure	COL name VAL dalal steel	1
COL name VAL the nour al_din al_zinki movement	COL name VAL nour el_din el_zinki	1
COL name VAL alsumaria news	COL name VAL alsumaria tv	0
COL name VAL front of islamist action	COL name VAL islamist front	1
COL name VAL boehringer ingelheim middle east	COL name VAL boehringer ingelheim	0
COL name VAL horras al_din	COL name VAL hurras al_deen	0
COL name VAL formosa plastics	COL name VAL formosa tv	0
COL name VAL chelsea football club	COL name VAL ahed football club	0
COL name VAL the 15th brigade support battalion	COL name VAL the support brigade	0
COL name VAL the lebanese amb group	COL name VAL amb group	1
COL name VAL the societe saint vincent de paul	COL name VAL the saint vincent de paul association	1
COL name VAL the national immigration law center	COL name VAL the national immigrant justice center	1
COL name VAL mustaqbal bloc	COL name VAL amal mustaqbal	0
COL name VAL national nna	COL name VAL national oil co	0
COL name VAL the democratic societycongress	COL name VAL socotec liban	0
COL name VAL the trans arabian pipe line company	COL name VAL arabian construction company	0
COL name VAL ansar beit al_maqdas	COL name VAL ansar bait al_maqdis	1
COL name VAL train and equip	COL name VAL iraq train and equip fund	1
COL name VAL the national dialogue	COL name VAL this national dialogue	1
COL name VAL the world values survey	COL name VAL world values survey	1
COL name VAL the board of the lebanese omani businessmen gathering	COL name VAL the gathering of business men	0
COL name VAL usaid oti civil society partners	COL name VAL lebanese civil society	0
COL name VAL the al_zakat fund	COL name VAL the zakat fund	1
COL name VAL medinvestment bank s a l	COL name VAL credit libanais investment bank s a l	0
COL name VAL the alliance for peace and freedom	COL name VAL the women international league for peace and freedom	0
COL name VAL the luhansk information center	COL name VAL the legal information center	0
COL name VAL the maritime diving club	COL name VAL the calypso diving club	0
COL name VAL the egyptian initiative for personal rights	COL name VAL egyptian initiative for personal rights	1
COL name VAL state tourism promotion board	COL name VAL the tourism promotion board	1
COL name VAL the association of medrar abdullah berri	COL name VAL medrar abdallah berri	1
COL name VAL lima group	COL name VAL malia group	0
COL name VAL internal trade and consumer protection	COL name VAL the ministry of internal trade and consumer protection	1
COL name VAL the national alliance in support of political participation in lebanon	COL name VAL the national coalition to support the establishment of women political participation in lebanon	0
COL name VAL the state program of accelerated industrial and innovative development	COL name VAL g 7 infighting	0
COL name VAL sfeir semler gallery	COL name VAL sfeir semler	1
COL name VAL the european recovery program	COL name VAL crisis prevention and recovery program	0
COL name VAL al_ahram weekly	COL name VAL us weekly	0
COL name VAL the heart of jesus church	COL name VAL the catholic university of the heart of jesus	0
COL name VAL the new world foundation for development and human rights	COL name VAL the beirut centre for development and human rights	0
COL name VAL lebanon taxi	COL name VAL lebanon 24	0
COL name VAL civil contingencies agency	COL name VAL the swedish civil contingencies agency	1
COL name VAL the egyptian ministry of health	COL name VAL the gaza ministry of health	1
COL name VAL the anti coup pro democracy alliance	COL name VAL pro morsi anti coup	0
COL name VAL the body shop	COL name VAL the pet shop boys	0
COL name VAL shehim institute	COL name VAL shyam institute	0
COL name VAL al_ahsa literary	COL name VAL al_ahsa literary club	1
COL name VAL aboriginal embassy	COL name VAL an aboriginal embassy	1
COL name VAL office for civil rights and civil liberties	COL name VAL the center for civil liberties	0
COL name VAL al_mustapha schools	COL name VAL al_mustafa schools	1
COL name VAL contingency fund for emergencies	COL name VAL the investment fund for emerging companies	0
COL name VAL the hadara school	COL name VAL the hadara highschool	0
COL name VAL counter proliferation department	COL name VAL the proliferation security initiative	0
COL name VAL the cleveland indians	COL name VAL civilian police	0
COL name VAL mothers of love	COL name VAL the digital mothers program	0
COL name VAL the communist party of the russian federation	COL name VAL the federation council of the russian federation	0
COL name VAL swedens central bank	COL name VAL sudanese media centre	0
COL name VAL champs fund associations	COL name VAL the champs fund	1
COL name VAL bbc radio five live	COL name VAL bbc radio 4s	0
COL name VAL the civil servants league	COL name VAL zeravani force	0
COL name VAL crystal exchange	COL name VAL the crystal exchange company sal	0
COL name VAL ubuntunet alliance	COL name VAL opendemocracy 50 50	0
COL name VAL five power defense arrangements	COL name VAL the orange house project	0
COL name VAL the actors workshop	COL name VAL sesame workshop	0
COL name VAL the serious crimes court	COL name VAL the counterterrorism and serious crimes bureau	0
COL name VAL small bear big heart	COL name VAL smile factory	0
COL name VAL the executive body	COL name VAL the lf executive body	1
COL name VAL toyota motor corp	COL name VAL tadi group	0
COL name VAL fidelity investments	COL name VAL fidelity insurance	0
COL name VAL al_ossoud al_sharqiya	COL name VAL jaish al_ossoud al_sharqiya	1
COL name VAL the common groundnews service	COL name VAL the common ground news service	1
COL name VAL the united nations office on drugs and crime	COL name VAL united nations office on drugs and crime	1
COL name VAL the together for missing persons association	COL name VAL onlus together association	0
COL name VAL the fabre museum	COL name VAL faber faber	0
COL name VAL russian capital company	COL name VAL the russian company	1
COL name VAL ta marbouta	COL name VAL ta marbout	1
COL name VAL the central laboratory	COL name VAL central laboratory	1
COL name VAL artists in residency program	COL name VAL ras masqa artists in residency	0
COL name VAL the charity tv network	COL name VAL future tv network	0
COL name VAL salmontini le resto	COL name VAL d rasati	0
COL name VAL shabab al_umma	COL name VAL al_shabab al	0
COL name VAL the north educational sector	COL name VAL the north lebanon department of the education ministry	0
COL name VAL the tactical operations center	COL name VAL malhama tactical	0
COL name VAL united nations office on drugs and crime	COL name VAL the united nations office on drugs and crime	1
COL name VAL al_qaeda 3 0	COL name VAL al_qaeda 13	0
COL name VAL academy of art college	COL name VAL collect art	1
COL name VAL the oxford research group	COL name VAL the national research group	0
COL name VAL the bayada martyrs battalion	COL name VAL the tal kalakh martyrs battalion	0
COL name VAL a harley davidson	COL name VAL harley davidson	1
COL name VAL standard and poors	COL name VAL standards and poor	1
COL name VAL wiener konzerthaus	COL name VAL the ixsir winery	0
COL name VAL grand hills hotel and spa	COL name VAL sobh hotel	0
COL name VAL amazon web services	COL name VAL wahhab nna	0
COL name VAL borussia moenchengladbach	COL name VAL borussia m ouml nchengladbach	0
COL name VAL the instituto mediterraneo di certificazione	COL name VAL the mediterranean institute of certification	1
COL name VAL the small arms survey	COL name VAL smile factory	0
COL name VAL together for life	COL name VAL together for a sustainable society	0
COL name VAL detroit news	COL name VAL the detroit free press	0
COL name VAL the experts assembly	COL name VAL the iranian assembly of experts	1
COL name VAL the institute for near east and gulf military analysis north america	COL name VAL the institute for gulf and near east military analysis	1
COL name VAL exploration department	COL name VAL examination department	0
COL name VAL trans mediterranean airways	COL name VAL the trans mediterranean airlines	0
COL name VAL stanford law school	COL name VAL fordham law school	0
COL name VAL an independent press standards organization	COL name VAL the international standardization organization	0
COL name VAL research for results	COL name VAL resolute union	0
COL name VAL the polish constitutional court	COL name VAL polish constitutional tribunal	0
COL name VAL mexican house	COL name VAL the lebanese mexican house	1
COL name VAL al_kalima online	COL name VAL america online	0
COL name VAL tosh fish	COL name VAL the tosh fesh	1
COL name VAL standard and poors	COL name VAL standard poor	0
COL name VAL shabab al_sahal	COL name VAL the al_shabab al_	0
COL name VAL the lebanese corruption observatory	COL name VAL the popular observatory to fight corruption	0
COL name VAL buy and sell in lebanon	COL name VAL eni lebanon b v	0
COL name VAL the union for concerned scientists	COL name VAL the second lebanese congregation	0
COL name VAL chocolat milano	COL name VAL comptoir du chocolat	0
COL name VAL british motor corporation	COL name VAL toyota motor corporation	0
COL name VAL private banking	COL name VAL credit suisse private banking	0
COL name VAL highness spa	COL name VAL highness spa and clinic	1
COL name VAL al_furqan media	COL name VAL liwa al_furqan	0
COL name VAL economic policy research foundation	COL name VAL the economic policy research foundation	1
COL name VAL the heinrich boll foundation	COL name VAL the heinrich b ll foundation	1
COL name VAL tayar mouwatana	COL name VAL le matin	0
COL name VAL the syrian electronic army	COL name VAL electronic army	1
COL name VAL five power defense arrangements	COL name VAL orange nassau	0
COL name VAL the border protection assistance program	COL name VAL the assistance program for the protection of the lebanese	0
COL name VAL new cabinet	COL name VAL sub cabinet	0
COL name VAL checkpoint charlies	COL name VAL checkpoint 303	0
COL name VAL al_sakhra battalion	COL name VAL the al_sakhra battalion	1
COL name VAL al_majles al_ahli	COL name VAL hay al_muallimeen	0
COL name VAL the house of commons treasury committee	COL name VAL the house of commons	1
COL name VAL department of chemical engineering	COL name VAL the department of chemical safety	1
COL name VAL the slaughterhouse directorate	COL name VAL the slaughterhouse authority	0
COL name VAL champs elysees	COL name VAL champs fund associations	0
COL name VAL a press complaints commission	COL name VAL the police complaints commission	0
COL name VAL the netherlands embassy	COL name VAL royal netherlands navy	0
COL name VAL the lebanese recovery fund	COL name VAL the syria recovery trust fund	0
COL name VAL revolutionary left	COL name VAL a revolutionary front	0
COL name VAL the royal academy of history of madrid	COL name VAL real madrid	0
COL name VAL the shirazi movement	COL name VAL the hirak movement	0
COL name VAL solarcity corp	COL name VAL solarcity inc	0
COL name VAL the guttmacher institute	COL name VAL l instant t	0
COL name VAL our cafe	COL name VAL la cave	0
COL name VAL tunis hebdo	COL name VAL charia hebdo	0
COL name VAL hydrocarbons corporation	COL name VAL the hydrographic department	0
COL name VAL sports and scouts	COL name VAL public organization for sports youth and scouts	0
COL name VAL the moscow times	COL name VAL cska moscow	0
COL name VAL miras consulting company	COL name VAL consolidated contractors company	0
COL name VAL iran air tours	COL name VAL iran wire	0
COL name VAL mediterranean politics	COL name VAL mediterranean hope	0
COL name VAL the bush hardware company	COL name VAL ace hardware	0
COL name VAL farmagul sultan	COL name VAL fatmagul sultan	1
COL name VAL france 2 television	COL name VAL france 5 television	0
COL name VAL arabic services	COL name VAL rt arabic	0
COL name VAL the constitutional bloc	COL name VAL the constitutional institutions	0
COL name VAL kitabat association	COL name VAL katibat al_nour	0
COL name VAL al_meqdad clan	COL name VAL x clan	0
COL name VAL hadi maktabi gallery	COL name VAL the hadi maktabi art gallery	1
COL name VAL baalbek hermel regional unit	COL name VAL baalbek hermel	0
COL name VAL legislative committee	COL name VAL the legislative party	0
COL name VAL the sudan tribune	COL name VAL sudan tribune	1
COL name VAL the international loan program	COL name VAL the office of international programs	0
COL name VAL the nelson giants	COL name VAL the giants brigades	0
COL name VAL thawra crushes	COL name VAL liu crushes	0
COL name VAL the global fund to fight aids tuberculosis and malaria	COL name VAL the global fund to fight aids tuberculosis and malaria and gavi	1
COL name VAL the british journal of general practice	COL name VAL the british journal of political science	0
COL name VAL the british telegraph	COL name VAL british telegraph	1
COL name VAL the physical therapy department	COL name VAL the physician department	0
COL name VAL mideast aircraft services company	COL name VAL mideast aircraft service company	1
COL name VAL bureau technique pour le developpement	COL name VAL pro u s	0
COL name VAL the daily item	COL name VAL the daily wire	0
COL name VAL the institute for new economic thinking	COL name VAL thinking and action group	0
COL name VAL saudi telecom corporation	COL name VAL saudi telecom company	0
COL name VAL real sociedad	COL name VAL sociedade esportiva palmeiras	0
COL name VAL the directorate general for urban planning	COL name VAL the directorate for urban planning	1
COL name VAL lycee abdel kader school	COL name VAL lycee abdel kader	1
COL name VAL the palestinian youth organization for humanitarian relief	COL name VAL ighatheyya relief	0
COL name VAL lostock hall primary school	COL name VAL premiership nna	0
COL name VAL box office	COL name VAL virgin box office	1
COL name VAL arqoub citizen committee	COL name VAL the arqoub citizens committee	1
COL name VAL the azov battalion	COL name VAL the 2 31st battalion	0
COL name VAL the murex d or committee	COL name VAL murex d or committee	1
COL name VAL mideast markets	COL name VAL u n mideast	0
COL name VAL cinco lounge	COL name VAL art lounge	0
COL name VAL together for a safe childhood	COL name VAL together for a sustainable society	0
COL name VAL american mideast coalition for democracy	COL name VAL the american mideast coalition for democracy	1
COL name VAL the china banking regulatory commission	COL name VAL the china securities regulatory commission	1
COL name VAL entertainment weeklynaharnet	COL name VAL b aqleen	0
COL name VAL the service providers	COL name VAL the distribution service providers	1
COL name VAL al_sarab alternative dance school	COL name VAL the donghai elderly care hospital	0
COL name VAL aston martin	COL name VAL aston martins	1
COL name VAL the global philadelphia association	COL name VAL philadelphia university	0
COL name VAL the order of medicine importers and owners of medicine depots	COL name VAL medicines importers	0
COL name VAL baalbek hermel gov	COL name VAL baalbek hermel choice	0
COL name VAL amal mustaqbal	COL name VAL mustaqbal bloc	0
COL name VAL nerve centre	COL name VAL the nerve centre	1
COL name VAL trans mediterranean airlines	COL name VAL mediterranean affairs	0
COL name VAL a senate council	COL name VAL senates council	1
COL name VAL sovereign front	COL name VAL sovereignty first	0
COL name VAL the 2nd cavalry regiment	COL name VAL the 2nd artillery regiment	0
COL name VAL adult swim	COL name VAL swim h2020	0
COL name VAL the chaldean diocese of beirut	COL name VAL the diocese of miao	0
COL name VAL the european organisation for the safety of air navigation	COL name VAL the air navigation department	0
COL name VAL the najafa brothers	COL name VAL the najaf hawza	0
COL name VAL ein teenh	COL name VAL ayn tineh	0
COL name VAL the executive council of asia pacific news agencies	COL name VAL asian and pacific news agencies executive council	1
COL name VAL modeo systems	COL name VAL food systems	0
COL name VAL the syrian response coordination group	COL name VAL the global crisis response group	0
COL name VAL the national body for anti	COL name VAL the national democratic body for democratic change	0
COL name VAL the national committee for prohibition of weapons	COL name VAL the national committee for the protection of the constitution and the law	0
COL name VAL the inclusive growth in cities initiative	COL name VAL the cities growth commission	0
COL name VAL the fishing club	COL name VAL byblos fishing club restaurant	0
COL name VAL breakthru productions	COL name VAL the breakthrough prize foundation	0
COL name VAL the prosecuting authority	COL name VAL the mount lebanon prosecuting authority	0
COL name VAL museu nacional	COL name VAL atletico nacional	0
COL name VAL a currency board	COL name VAL guernica 37	0
COL name VAL the movements committee	COL name VAL sahwa movement	0
COL name VAL the tahrir front	COL name VAL al_tahrir front	0
COL name VAL the islamic supreme shia council	COL name VAL islamic supreme shiite council	1
COL name VAL south deserves	COL name VAL south board	0
COL name VAL ipt energy center	COL name VAL the ipt energy center	1
COL name VAL women on the front lines	COL name VAL women on confronting lines	1
COL name VAL nour al_din zanki	COL name VAL nour al_din al_	0
COL name VAL the shahid javed burki institute of public policy	COL name VAL aub jafet	0
COL name VAL mena nna	COL name VAL irena nna	0
COL name VAL the aleppo rmc	COL name VAL rymco sal	0
COL name VAL ports and maritime organisation	COL name VAL the ports and maritime organization	1
COL name VAL healh ministry	COL name VAL gaza health ministry	0
COL name VAL united world colleges	COL name VAL the higher colleges of technology	0
COL name VAL camp on legislation	COL name VAL legislation body	0
COL name VAL bkirki hizbullah dialogue committee	COL name VAL the committee of bkerki	0
COL name VAL the national permanent committee for senior citizens care	COL name VAL the permanent committee for arab media	0
COL name VAL the episcopal church	COL name VAL the episcopal councils	0
COL name VAL voice of people	COL name VAL the voice of the people	1
COL name VAL the labor union	COL name VAL the world labor union	1
COL name VAL the university college london institute for sustainable resources	COL name VAL the institute for sustainable resources	0
COL name VAL the knights templars	COL name VAL knights templar	1
COL name VAL convention on domestic workers	COL name VAL the domestic workers union	0
COL name VAL the group of five plus one	COL name VAL group plus	0
COL name VAL institute for the regulation and control of cannabis	COL name VAL aurora cannabis	0
COL name VAL lora enterprises limited	COL name VAL usaifa international limited	0
COL name VAL the bernstein program on gulf and energy policy	COL name VAL the energy policy and security program	0
COL name VAL the santa chiara lab	COL name VAL saint coeur high	0
COL name VAL the tourism promotion board	COL name VAL the tourism promotion authority	0
COL name VAL alcoholics anonymous	COL name VAL lior anonymous team	0
COL name VAL girard nna	COL name VAL girard nna army	1
COL name VAL maroon 5	COL name VAL ssa marine	0
COL name VAL the land institute	COL name VAL the wahid institute	0
COL name VAL der spiegel	COL name VAL der spiegel online	1
COL name VAL sawt el_mada	COL name VAL sawt al_mada	1
COL name VAL bshamoun specialty hospital	COL name VAL the king faisal specialist hospital	0
COL name VAL the arab british centre starch foundation	COL name VAL the starch foundation	0
COL name VAL the arab african council for integration and development	COL name VAL the euro arab association for development and integration	0
COL name VAL the slow food foundation	COL name VAL slow food	1
COL name VAL baalbek hermel	COL name VAL the baalbek hermel department	1
COL name VAL georgia tech	COL name VAL georgia tech university	1
COL name VAL the hague institute for legal innovation creative justice	COL name VAL institute for peace and justice	0
COL name VAL the university of aix marseille	COL name VAL the university of versailles	0
COL name VAL the partido revolucionario institucional	COL name VAL resistance bridades	0
COL name VAL wata al_mousaytbeh	COL name VAL wata al_musaytbeh	1
COL name VAL ihs jane defence weekly	COL name VAL jane defense weekly	0
COL name VAL the butch embassy	COL name VAL the czech embassy	0
COL name VAL the saydet el_jabal association	COL name VAL saidat el_jabal association	0
COL name VAL the federal democratic system of rojava	COL name VAL the peshmerga of rojava	0
COL name VAL jamal and shaaban institute	COL name VAL jamali nna	0
COL name VAL aam aadmi	COL name VAL aam aadmi party	1
COL name VAL territorial company	COL name VAL first territorial company	1
COL name VAL al_shabab al	COL name VAL al_shabab al_arabi	0
COL name VAL the mashayekh al_aql	COL name VAL mashayekh al_aql	1
COL name VAL faculty of education	COL name VAL the faculty of education	1
COL name VAL the kennan institute	COL name VAL the croatan institute	0
COL name VAL bureau of counterterrorism	COL name VAL pir centre	0
COL name VAL standard chartered bank	COL name VAL standard chartered plc	0
COL name VAL the episcopal councils	COL name VAL episcopal council	1
COL name VAL lycee abdel kader	COL name VAL lycee abdel kader school	1
COL name VAL the platform for action	COL name VAL the lebanese center for palliative care	0
COL name VAL pulse production	COL name VAL minime production	0
COL name VAL talal abughazaleh graduate school of business	COL name VAL stanford graduate school of business	0
COL name VAL the online community	COL name VAL 5aleek online	0
COL name VAL the luxury lifestyle awards	COL name VAL london luxury lifestyle awards	1
COL name VAL le gray indigo on the roof	COL name VAL le greyindigo on the roof	1
COL name VAL aljadid manpower services	COL name VAL manbar al_tawheed wa al_jihad	0
COL name VAL the tadamoun party	COL name VAL tadamun solidarity party	1
COL name VAL awqaf and charity affairs organization	COL name VAL endowment and charity affairs organization	1
COL name VAL dox box	COL name VAL le bacchus	0
COL name VAL the primary committee	COL name VAL premiership nna	0
COL name VAL us airways	COL name VAL cyrus airways	0
COL name VAL the united front work department	COL name VAL united front	0
COL name VAL greuther furth	COL name VAL fourth battalion	0
COL name VAL 5th intervention unit	COL name VAL the special intervention unit	0
COL name VAL the aspen institute	COL name VAL aspen institute	1
COL name VAL the ukrainian canadian congress	COL name VAL the continental congress	0
COL name VAL albatross consultancy ltd	COL name VAL elbit systems ltd	0
COL name VAL nippon steel sumitomo metal factory	COL name VAL nbn t v	0
COL name VAL the sindh rural support organization	COL name VAL the sound and picture organization	0
COL name VAL the united states government	COL name VAL the united kingdom government	0
COL name VAL global dawn	COL name VAL g global	0
COL name VAL prodes association	COL name VAL mills association	0
COL name VAL blue bay lpga	COL name VAL bw lpg	0
COL name VAL the roman republic	COL name VAL the republican palace	0
COL name VAL civic influence hub	COL name VAL the civic influence hub	1
COL name VAL vdl 100 5	COL name VAL vdl 93 3	0
COL name VAL gray wolves	COL name VAL the night wolves	0
COL name VAL the printania palace hotel	COL name VAL printania palace	1
COL name VAL united therapeutics	COL name VAL tripadvisor com	0
COL name VAL gas distributors syndicate	COL name VAL the gas cylinders distribution syndicate	1
COL name VAL committee on budgetary control	COL name VAL the center for strategic and budgetary assessments	0
COL name VAL the american society of animal science	COL name VAL the world society for the protection of animals	0
COL name VAL byblos fishing club	COL name VAL byblos fishing club restaurant	1
COL name VAL friends of cedar forest	COL name VAL the committee of the friends of the cedar forest	1
COL name VAL the maan together campaign for civil peace	COL name VAL learning together	0
COL name VAL vanity fair	COL name VAL vanity fairs	1
COL name VAL the rassemblement constitutionnel democratique	COL name VAL constitutional democratic rally	0
COL name VAL saudi gazette	COL name VAL the saudi gazette	1
COL name VAL dr nazih bizri high school	COL name VAL bazourieh high school	0
COL name VAL orange nassau	COL name VAL the orange house project	0
COL name VAL front of islamist action	COL name VAL joint action front	0
COL name VAL the u s drug enforcement agency	COL name VAL drug enforcement agency	1
COL name VAL reserve officers training	COL name VAL afkar i	0
COL name VAL tadamon sour	COL name VAL tadamon beirut	0
COL name VAL akhbar al_yawm	COL name VAL the akhbar al_yawm	1
COL name VAL the bacchus temple	COL name VAL temple arles books	0
COL name VAL start up lebanon	COL name VAL yalla start up	0
COL name VAL ahl al_nusra	COL name VAL ahl al_	0
COL name VAL the beverly hilton hotel	COL name VAL le beverley	0
COL name VAL the hellenic rescue team	COL name VAL hualong one	0
COL name VAL road and urban development	COL name VAL suburban development	0
COL name VAL the indonesian diaspora network	COL name VAL the european parliamentary network on diaspora and diaspora policies in the world	0
COL name VAL constitutional council leader	COL name VAL la lettura	0
COL name VAL central asia network	COL name VAL usa network	0
COL name VAL sarrader bank	COL name VAL saradar bank	1
COL name VAL invesco powershares	COL name VAL borchardt hume	0
COL name VAL dinamo zagreb	COL name VAL dynamo zagreb	1
COL name VAL food and drink federation problem	COL name VAL g tronic	0
COL name VAL albert einstein hospital	COL name VAL al_bayrouni hospital	0
COL name VAL chambers and partners	COL name VAL shair and partners	0
COL name VAL national electric utility	COL name VAL the national electric utility	1
COL name VAL business lobby	COL name VAL business fm	0
COL name VAL the global partnership to end violence against children	COL name VAL association of media against violence	0
COL name VAL master chips and poppins	COL name VAL master chips	1
COL name VAL the directorate general for urban planning	COL name VAL the directorate general of urban planning	1
COL name VAL emirates nbd	COL name VAL emirates air	0
COL name VAL the fletcher school of law and diplomacy	COL name VAL the fletcher school	0
COL name VAL qabr shmoun hospital	COL name VAL bshamoun hospital	0
COL name VAL the district of columbia circuit	COL name VAL federal district court of columbia	0
COL name VAL malankara church	COL name VAL melenkart church synod	0
COL name VAL international university crushes	COL name VAL thawra crushes	0
COL name VAL al_marej organic farms and food store	COL name VAL al_marej organic food	1
COL name VAL us airways	COL name VAL the city is ours	0
COL name VAL jihad construction	COL name VAL jihad construction foundation	1
COL name VAL the laklouk village vacances	COL name VAL sport village	0
COL name VAL the solicitors regulation authority	COL name VAL nuclear regulation authority	0
COL name VAL industry trade small and medium sized enterprises	COL name VAL the national fund for small and medium enterprise sme development	0
COL name VAL international catholic legislators network	COL name VAL the legislative party	0
COL name VAL the tokyo district court	COL name VAL the district court of the hague	0
COL name VAL official monetary and financial institutions forum	COL name VAL ant farm	0
COL name VAL trans mediterranean airlines	COL name VAL the trans mediterranean airlines	1
COL name VAL the benevolent pharmacy	COL name VAL benevolent pharmacy	1
COL name VAL the food village	COL name VAL sport village	0
COL name VAL territorial gendarmerie	COL name VAL arsal gendarmerie	0
COL name VAL gulf corporation council	COL name VAL the gulf corporations council	1
COL name VAL erasmus university	COL name VAL erasmus huis	0
COL name VAL atlas magazine	COL name VAL das magazin	0
COL name VAL farah trading group	COL name VAL global trading group	0
COL name VAL the global fund to fight aids tuberculosis and malaria and gavi	COL name VAL the global fund to fight aids tb and malaria	0
COL name VAL woodrow wilson center fellowship	COL name VAL woodrow wilson school	0
COL name VAL the harvard advanced leadership initiative	COL name VAL the adventures of salwa initiative	0
COL name VAL le monde de la musique	COL name VAL the fete de la musique	0
COL name VAL the al_bayan center	COL name VAL bayan center	0
COL name VAL saraya ahl al_sham	COL name VAL saraya al_	0
COL name VAL the levant front	COL name VAL levant front	1
COL name VAL al_qaida in the islamic maghreb	COL name VAL al_qaeda in the islamic maghreb	1
COL name VAL the hebrew university of jerusalem faculty of law	COL name VAL the jerusalem school of law	0
COL name VAL ein teeneh lf	COL name VAL ein teenh	1
COL name VAL sidon and jezzine together	COL name VAL together we go company	0
COL name VAL fondazione merz	COL name VAL fondazione minoprio	0
COL name VAL the george washington university center for extremism	COL name VAL the george washington university	1
COL name VAL action for hope	COL name VAL the action for hope film school	1
COL name VAL the foundation interpol	COL name VAL interpol foundation	1
COL name VAL jafet libraries	COL name VAL jafet library	1
COL name VAL the office of the assistant secretary of state for economic affairs	COL name VAL state secretariat for economic affairs	0
COL name VAL american airlines group inc	COL name VAL airline data inc	0
COL name VAL the international palaces academy	COL name VAL the tall blacks	0
COL name VAL the maine lobstermen association	COL name VAL 350 maine	0
COL name VAL the u s national academies	COL name VAL the academie national de cuisine	0
COL name VAL the canadian house of commons	COL name VAL the british house of commons	1
COL name VAL maronite tribunal	COL name VAL the u n tribunal	0
COL name VAL alliance for public interest technology	COL name VAL the fur free alliance	0
COL name VAL conflict security and stability fund	COL name VAL conflict and stability fund	1
COL name VAL the supreme government of the united provinces of south america	COL name VAL the united provinces	0
COL name VAL the supreme board of judges and prosecutors	COL name VAL the disciplinary board of judges	0
COL name VAL private hospitals order	COL name VAL private hospitals owners	0
COL name VAL ibl al_saqi official school	COL name VAL ein ibl high school school	0
COL name VAL the humane society	COL name VAL the wine society	0
COL name VAL the sunday times of london	COL name VAL the sunday times	1
COL name VAL the judicial inspection commission	COL name VAL higher judicial election commission	0
COL name VAL reina club	COL name VAL china club	0
COL name VAL u s carnegie endowment for international peace	COL name VAL the carnegie endowment	0
COL name VAL the international union against tuberculosis and lung disease	COL name VAL dprkhealth org	0
COL name VAL european citizens panel	COL name VAL the european citizens initiative	0
COL name VAL standard chartered	COL name VAL standard chartered bank	1
COL name VAL houston methodist debakey heart and vascular center	COL name VAL the united methodist church	0
COL name VAL the lake tahoe visitors authority	COL name VAL the league to save lake tahoe	0
COL name VAL mother france	COL name VAL mother russia	0
COL name VAL the central office for combatting trafficking in cultural property	COL name VAL century properties	0
COL name VAL farrar straus and giroux books for younger readers	COL name VAL pacos ferreira	0
COL name VAL mothers of the plaza de mayo	COL name VAL the grandmothers of plaza de mayo	1
COL name VAL the original five	COL name VAL urgenda foundation	0
COL name VAL saint joseph hospital	COL name VAL saint jude hospital	0
COL name VAL francophone press union	COL name VAL the francophone union	1
COL name VAL mtv news	COL name VAL mtv nna	0
COL name VAL the human rights campaign	COL name VAL the human rights component	0
COL name VAL the africa progress panel	COL name VAL africa progress panel	1
COL name VAL habtoor group	COL name VAL al_habtoor group	0
COL name VAL mckinsey and co	COL name VAL mckinsey company	0
COL name VAL the spitzer science center	COL name VAL the spitzer school of architecture	0
COL name VAL realclearpolitics com	COL name VAL religare arts	0
COL name VAL zouwar imam al_rida	COL name VAL zuwwar imam al_rida	1
COL name VAL the cinematheque francaise	COL name VAL cinematheque tanger	0
COL name VAL nissan renault	COL name VAL renault nissan alliance	1
COL name VAL un court	COL name VAL u n court	1
COL name VAL the einstein papers project	COL name VAL chili peppers	0
COL name VAL the arab teacher union secretariat	COL name VAL the public high school teacher league	0
COL name VAL the oneissi defense	COL name VAL oneissi defense	1
COL name VAL syria recovery trust fund	COL name VAL the syria recovery trust fund	1
COL name VAL bureau for conflict and stabilization operations	COL name VAL conflict and stability fund	0
COL name VAL act for america	COL name VAL teach for america	0
COL name VAL party media secretariat	COL name VAL the board of secretaries	0
COL name VAL arab finance house	COL name VAL arab financial support	0
COL name VAL guardian australia	COL name VAL australian aid	0
COL name VAL non opec output	COL name VAL non opec oil	0
COL name VAL the nicolas chahine weather station	COL name VAL the nicholas shahin weather station	1
COL name VAL mckenzie consulting	COL name VAL mckenzie company	0
COL name VAL the insa yougov	COL name VAL insa yougov	1
COL name VAL loubnan al_mahabba	COL name VAL loubnan al_mahaba	1
COL name VAL the litani project	COL name VAL the litani irrigation project	1
COL name VAL the doctors order in beirut	COL name VAL beirut order	0
COL name VAL oil contracts revision committee	COL name VAL revision military	0
COL name VAL k2p center	COL name VAL equip center	0
COL name VAL hospitals owners syndicate	COL name VAL private hospitals owners syndicate	1
COL name VAL ibc company	COL name VAL admic company	0
COL name VAL cedar oxygen fund	COL name VAL nna cedar oxygen	1
COL name VAL the bin laden group	COL name VAL ben laden company	0
COL name VAL fatah al_intifada	COL name VAL fatah intifada	1
COL name VAL anti al_qaeda	COL name VAL ex al_qaeda	0
COL name VAL the eye and ear hospital	COL name VAL air india	0
COL name VAL army of conquest	COL name VAL conquest army	1
COL name VAL lora enterprises limited	COL name VAL qatar petroleum international limited	0
COL name VAL the sheikh khalifa ben zayed foundation	COL name VAL sheikh khalifa ben zayed	1
COL name VAL bkirky committee	COL name VAL the bkirki committee	1
COL name VAL rechmaya distillery	COL name VAL reclaim the power	0
COL name VAL the intisar foundation	COL name VAL the foundation interpol	0
COL name VAL phoenicia trading	COL name VAL dreadnoughts international	0
COL name VAL the democratic left alliance	COL name VAL democratic left alliance	1
COL name VAL the february 17 brigade	COL name VAL the coalition of the 17th february revolution	0
COL name VAL 1 1 centre for art and politics	COL name VAL center for current politics	0
COL name VAL the marriott marquis hotel	COL name VAL markazia hotel	0
COL name VAL the citizen reception office	COL name VAL ottawa citizen	0
COL name VAL army of conquest	COL name VAL jaish al_islam army of conquest	1
COL name VAL kuwaiti al_qabas	COL name VAL kuwaiti al_anba	1
COL name VAL saudi okaz	COL name VAL actes sud	0
COL name VAL an informal expert group ieg	COL name VAL ocp group	0
COL name VAL the lycee abdel kader	COL name VAL the lycee abdel kader school	1
COL name VAL ajyal arab center	COL name VAL ajyal salima	0
COL name VAL the legal representatives of the victims	COL name VAL legal representatives of victims	1
COL name VAL penn state hershey college of medicine	COL name VAL college of medicine	0
COL name VAL neturei karta international	COL name VAL neturei karta international movement	1
COL name VAL the alpha group for statistical consultancy	COL name VAL alpha group	0
COL name VAL the nutrition business journal	COL name VAL the journal of food and nutritional disorders	0
COL name VAL hamburger baytna	COL name VAL hamburg sud	0
COL name VAL the council of delegates	COL name VAL the council of decorations	0
COL name VAL walkabout drum circle	COL name VAL the walkabout drum circle	1
COL name VAL arabia insurance	COL name VAL lia insurance sal	0
COL name VAL the central crisis cell	COL name VAL a crisis cell	0
COL name VAL the olympic council of asia	COL name VAL asia olympic council	1
COL name VAL fanar research center	COL name VAL fata research center	1
COL name VAL bloomberg agency	COL name VAL bloomberg news agency	1
COL name VAL institute for peace and justice	COL name VAL the institute of justice	1
COL name VAL stl ned whalley	COL name VAL stl ned	1
COL name VAL sham al_islam movement	COL name VAL sham al_islam	1
COL name VAL louis cardahi foundation	COL name VAL kordahi nna	0
COL name VAL al_joumhhouria daily	COL name VAL al_joumhoria daily	1
COL name VAL the kurdistan islamic union	COL name VAL the kurdistan communities union	0
COL name VAL the global road safety partnership	COL name VAL global preparedness partnership	0
COL name VAL sky sport	COL name VAL the sacre coeur sports club	0
COL name VAL waverly elementary	COL name VAL waverly junior high	0
COL name VAL close up	COL name VAL casa wabi	0
COL name VAL renault nissan	COL name VAL the renault nissan alliance	1
COL name VAL media legal defense initiative	COL name VAL seeds for legal initiatives	0
COL name VAL european free alliance	COL name VAL the fur free alliance	0
COL name VAL lancaster tamar hotel hadat	COL name VAL tamar lancaster hotel	1
COL name VAL kickboxing federation	COL name VAL the kickboxing union of lebanon	0
COL name VAL the france medias monde academy	COL name VAL the academie france medias monde	1
COL name VAL early manuscripts electronic library	COL name VAL the early manuscripts electronic library	1
COL name VAL the detroit lions	COL name VAL detroit lions	1
COL name VAL the union of domestic worker agencies	COL name VAL the domestic workers union	1
COL name VAL osama habib jammal trust bank	COL name VAL jammal trust	0
COL name VAL the business leaders forum	COL name VAL g 20 leaders	0
COL name VAL summer collective	COL name VAL the good food collective	0
COL name VAL jbeil public high school	COL name VAL jubilee school	0
COL name VAL heliopolis cooperative	COL name VAL safir heliopolis	0
COL name VAL ta marbout	COL name VAL teh marbouta	0
COL name VAL the house of representatives committee on foreign affairs	COL name VAL u s house committee on foreign affairs	0
COL name VAL the al_rahma dispensary	COL name VAL al_rahma medical dispensary	1
COL name VAL the u s 2nd army cavalry regiment	COL name VAL the 2nd cavalry regiment	0
COL name VAL the san antonio express	COL name VAL san antonio express	1
COL name VAL airforce intelligence	COL name VAL euroforce headquarters	0
COL name VAL armenian reconciliation commission	COL name VAL truth and reconciliation commission	0
COL name VAL the federal writers project	COL name VAL lebanon riders	0
COL name VAL brussels conference	COL name VAL the brussels iv conference	1
COL name VAL kuwait airways airline	COL name VAL kuwait airways corp	0
COL name VAL southern weekend	COL name VAL southern weekly	0
COL name VAL the nx martial arts and fitness academy	COL name VAL academic and arts committee	0
COL name VAL stars academy	COL name VAL yes academy	0
COL name VAL lina cafe	COL name VAL la cave	0
COL name VAL syria al_ghad	COL name VAL al_qaida in syria	0
COL name VAL army post	COL name VAL la posta	0
COL name VAL the institute of remote sensing and digital earth	COL name VAL the cnrs remote sensing center	0
COL name VAL oneissi defence	COL name VAL the oneissi defense	0
COL name VAL tara mediterranee	COL name VAL sos mediterranee sar	0
COL name VAL ahrar syria	COL name VAL ahrar al_	0
COL name VAL eb international consulting limited	COL name VAL kafak enterprises limited	0
COL name VAL operation big blue association	COL name VAL operation big blue	1
COL name VAL independent sunni	COL name VAL the independent sunni deputies	1
COL name VAL the ideas factory	COL name VAL ideaz factory	1
COL name VAL ffa private bank	COL name VAL the hsbc private bank	0
COL name VAL the young mediterranean voices	COL name VAL the young mediterranean voices programme	1
COL name VAL label queen and	COL name VAL white label project	0
COL name VAL dar al_handasah nazih taleb and partners	COL name VAL the global islands partnership	0
COL name VAL united nations office on drugs and crime	COL name VAL office on drug and crime	0
COL name VAL leadership equity and diversity	COL name VAL leadership and the constitution	0
COL name VAL real madrid camps	COL name VAL real madrid	1
COL name VAL beirut waterfront development company	COL name VAL the waterfront city center mall	0
COL name VAL baalbeck madinati	COL name VAL beirut madinati	0
COL name VAL marj ayoun hassbayah	COL name VAL merje youn hasbaya	0
COL name VAL the american society for clinical oncology	COL name VAL the society of gynecological oncologists in lebanon	0
COL name VAL tibneen secondary school	COL name VAL amchit secondary school	0
COL name VAL the family protection department	COL name VAL civil protection department	0
COL name VAL ccia bml	COL name VAL the pml n	0
COL name VAL the ecole polytechnique	COL name VAL ecole polytechnique	1
COL name VAL oxford astra zeneca	COL name VAL astra zeneca	1
COL name VAL ibn sina middle school for boys	COL name VAL four paws	0
COL name VAL rolling stone magazine	COL name VAL the rolling stone record guide	0
COL name VAL europe 1 radio	COL name VAL radio free europe	0
COL name VAL the lebanese recovery fund	COL name VAL syria recovery trust fund	0
COL name VAL rosary sisters	COL name VAL the rosary sisters hospital	1
COL name VAL the london review of books	COL name VAL the new york review of books	0
COL name VAL the unicorn children foundation	COL name VAL the children of africa foundation	0
COL name VAL the oneissi defence	COL name VAL oneissi defense	0
COL name VAL antonin monasteries	COL name VAL indianu n	0
COL name VAL jimi and the saint	COL name VAL jum a	0
COL name VAL radical ideology	COL name VAL the global center for combating extremist ideology	0
COL name VAL usaifa international limited	COL name VAL eb international consulting limited	0
COL name VAL studiocur art	COL name VAL the stuttgart ballet	0
COL name VAL mtv news	COL name VAL itv news	0
COL name VAL slavia prague	COL name VAL slave to sirens	0
COL name VAL the catalan cabinet	COL name VAL the syrian cabinet	0
COL name VAL tree of life	COL name VAL the tree of life congregation	1
COL name VAL sodeco gestion	COL name VAL the institut de gestion hoteliere dikwaneh	0
COL name VAL kfc tripoli	COL name VAL drc tripoli	0
COL name VAL the sorrowful mother church	COL name VAL mother france	0
COL name VAL mirna cakes	COL name VAL eni kogas	0
COL name VAL sos mediterranee	COL name VAL tara mediterranee	0
COL name VAL baalbeck hermel	COL name VAL baalbeck hermel gov	1
COL name VAL golden lili resort and spa	COL name VAL the golden tulip marina resort	0
COL name VAL the international chamber of arbitration consulting	COL name VAL the chamber of maritime arbitration	0
COL name VAL cyber command	COL name VAL la creperie	0
COL name VAL the border control project	COL name VAL border control committee	0
COL name VAL the pashtun rights movement	COL name VAL pashtun pact	0
COL name VAL sheikh zayed bin sultan al_nahyan	COL name VAL ziad ben sultan al_nahyan	0
COL name VAL the bank of ningbo	COL name VAL bank of ningbo	1
COL name VAL the general directorate for islamo christian dialogue	COL name VAL the general directorate for islamic endowments	0
COL name VAL coalition against daesh	COL name VAL an islamic coalition against daesh	1
COL name VAL nl tc 205 environmental performance in buildings	COL name VAL taiko drumming performance	0
COL name VAL prince claus fund	COL name VAL the bronx zoo	0
COL name VAL petroleum and natural gas of india	COL name VAL the natural gas board	0
COL name VAL the lau school of pharmacy	COL name VAL the school of pharmacy	1
COL name VAL the ansarullah movements	COL name VAL the ansurallah movement	1
COL name VAL islamic cooperation council	COL name VAL islamic cooperation center	0
COL name VAL the european citizens initiative	COL name VAL european citizens panel	0
COL name VAL anheuser busch inbev	COL name VAL anheuser busch	1
COL name VAL harakat al_muqawama al_islamiyya	COL name VAL harakat amal	0
COL name VAL the association of fine arts workshop for culture and arts	COL name VAL the rashaya plastic arts workshop	0
COL name VAL the lebanese court system	COL name VAL the lebanese correction system	0
COL name VAL trans european mobility programme for university studies	COL name VAL at t mobility	0
COL name VAL irfan establishment	COL name VAL real establishment	0
COL name VAL bureau of fisheries	COL name VAL fisheries and oceans canada	0
COL name VAL kempinski summerland hotel	COL name VAL summerland hotel	1
COL name VAL cocoa co	COL name VAL ccc s a l	0
COL name VAL total e p liban s a l	COL name VAL total e p liban sal	1
COL name VAL qeshm fars air	COL name VAL fars qeshm	1
COL name VAL the islamic turkish union for religion	COL name VAL the religion security council	0
COL name VAL the talal abu_ghazaleh confucius institute	COL name VAL talal abu_ghazaleh confucius institution	1
COL name VAL the esalen institute	COL name VAL the milken institute	0
COL name VAL medico international	COL name VAL circo international	0
COL name VAL moutahed james jabra beirut club	COL name VAL james jabra beirut club	1
COL name VAL united kingdom marine trade operations	COL name VAL the united kingdom maritime trade operations	1
COL name VAL hard rock cafe	COL name VAL hard rock	1
COL name VAL kuwait airways corp	COL name VAL the kuwait airways	1
COL name VAL the british embasy	COL name VAL the irish embassy	0
COL name VAL saraya ahl al_sham	COL name VAL saraya al_sham	1
COL name VAL mustaqbal psp	COL name VAL amal mustaqbal	0
COL name VAL al_akhbar s a l	COL name VAL a al_akhbar	0
COL name VAL emirate airlines	COL name VAL emirates airlines	1
COL name VAL al_nahar weekly	COL name VAL entertainment weekly	0
COL name VAL public relations office	COL name VAL army public relations	0
COL name VAL karz productions	COL name VAL abbout productions	0
COL name VAL the kenyanred cross	COL name VAL the kenyared cross	1
COL name VAL hony capital	COL name VAL perry capital	0
COL name VAL the national alliance to support legitimacy	COL name VAL the national alliance for supporting legitimacy and rejecting the coup said	0
COL name VAL the duroy hotel	COL name VAL duroy hotel	1
COL name VAL stow waterfront holding	COL name VAL beirut waterfront development s a l	0
COL name VAL highness clinic	COL name VAL highness spa and clinic	1
COL name VAL mbc ventures	COL name VAL leap ventures	0
COL name VAL the religious cultural tourism project	COL name VAL religious cultural tourism project	1
COL name VAL islamic awqaf	COL name VAL the islamic awqaf	1
COL name VAL henry heald shipping and insurance co	COL name VAL henry heald	0
COL name VAL the china foundation for international studies	COL name VAL interpol foundation	0
COL name VAL polisario front	COL name VAL frente polisario	1
COL name VAL chateau marsyas	COL name VAL shiite duo	0
COL name VAL the sovereignty alliance for iraq	COL name VAL the sovereign front	0
COL name VAL new charter	COL name VAL un charter	0
COL name VAL the royal army medical corps	COL name VAL royal army	0
COL name VAL the brazilian embassy	COL name VAL the brazilian navy	0
COL name VAL clarity ray	COL name VAL u n court	0
COL name VAL non opec oil	COL name VAL abc 03	0
COL name VAL tbilisi court	COL name VAL the tbilisi state opera orchestra	0
COL name VAL sporting gijon	COL name VAL kahana chai	0
COL name VAL aer lingus	COL name VAL lancaster university	0
COL name VAL new delhi television	COL name VAL new television	1
COL name VAL amal educational institutions schools	COL name VAL ali jammal social education institutions	0
COL name VAL the brasiliban cultural center	COL name VAL the brazil lebanon cultural center	0
COL name VAL stl rhys dubin	COL name VAL hrw rhys dubin	0
COL name VAL the first corps	COL name VAL the 5th corps	0
COL name VAL the fista step together association	COL name VAL together for lebanon	0
COL name VAL the democratic current	COL name VAL the democratic left	0
COL name VAL halawi exchange	COL name VAL halawi exchange co	1
COL name VAL overseas private investment corp	COL name VAL the privatization and investment board	0
COL name VAL nahla el_zibawi veterans	COL name VAL nahla el_zibawi media	0
COL name VAL the permanent select committee on intelligence	COL name VAL the house of representatives permanent select committee on intelligence	1
COL name VAL the sharjah art foundation	COL name VAL the sharjah art foundations	1
COL name VAL ayn al_jawz	COL name VAL al_jadeed co	0
COL name VAL the credit suisse research institute	COL name VAL clalit research institute	0
COL name VAL woodrow wilson school	COL name VAL woodrow wilson institute	0
COL name VAL china radio international	COL name VAL circo international	0
COL name VAL jovo group	COL name VAL volvo group	0
COL name VAL ricerca e cooperazione	COL name VAL ricerca e cooperazione research and cooperation	1
COL name VAL the stamina mountaineering club	COL name VAL settimana coppi e bartali	0
COL name VAL irgc quds force	COL name VAL arctic council	0
COL name VAL the public prosecution office of cassation	COL name VAL cassation prosecutor office	1
COL name VAL the yemen army	COL name VAL the yemen post	0
COL name VAL the directorate general of islamic endowments	COL name VAL the general directorate of the islamic waqf	1
COL name VAL the giants brigades	COL name VAL the commemoration committees of the east giants	0
COL name VAL deux pi	COL name VAL miao diocese	0
COL name VAL overseas private investment corporation	COL name VAL overseas private investment corp	1
COL name VAL the association for volunteer services of offre joie	COL name VAL the national volunteer service program	0
COL name VAL das magazin	COL name VAL atlas magazine	0
COL name VAL the george mason university scalia law school	COL name VAL george washington university law school	0
COL name VAL the council of better business bureaus	COL name VAL paris council	0
COL name VAL international airlines group	COL name VAL al_ain international group	0
COL name VAL pan arab al_hayat	COL name VAL pan arab e infrastructures	0
COL name VAL the french embassy	COL name VAL the czech embassy	0
COL name VAL the syrian revolutionaries aleppo province	COL name VAL syrian revolutionaries aleppo countryside	1
COL name VAL the british ministry of defense for middle eastern affairs	COL name VAL the australian ministry of defense	0
COL name VAL the italian bishops conference	COL name VAL the u s conference of catholic bishops	0
COL name VAL cairo hackerspace	COL name VAL appalachian long distance hikers association	0
COL name VAL la gastronomique	COL name VAL le gastronomique	0
COL name VAL tate modern	COL name VAL modern tate	1
COL name VAL the world travel tourism council	COL name VAL dubai world travel	0
COL name VAL loubnan al_mahaba al_ijtimaiya al_insaniya	COL name VAL loubnan al_mahabba	0
COL name VAL the forum for memory and future	COL name VAL bmena forum for the future	1
COL name VAL purchasing managers index	COL name VAL blom lebanon purchasing managers index	1
COL name VAL the ruwwad al_islah movement	COL name VAL right to movement	0
COL name VAL absa group limited	COL name VAL usaifa international limited	0
COL name VAL estrella damm	COL name VAL u s eastern daylight time	0
COL name VAL the andrew w mellon foundation	COL name VAL inter milan	0
COL name VAL the people observatory	COL name VAL the athens observatory	0
COL name VAL the nepal tourism board	COL name VAL nepal tourism board	1
COL name VAL u n opinion	COL name VAL l opinion	0
COL name VAL the honorary consular corps	COL name VAL consular corps	1
COL name VAL the lebanon recovery fund	COL name VAL lebanon recovery framework	0
COL name VAL al_rajhi holding group	COL name VAL al_rajhi bank	0
COL name VAL sawt al_huriyya voice of liberty	COL name VAL sawt al_hurriya	0
COL name VAL cyber waves	COL name VAL waves company	0
COL name VAL world learning	COL name VAL world learning nna	1
COL name VAL medea babel theater	COL name VAL the babel theater	1
COL name VAL dynamo kiev	COL name VAL the kiev dynamo	1
COL name VAL the catharsis lebanese center for drama therapy	COL name VAL the order gathers us	0
COL name VAL the al_bire hospital	COL name VAL the al_salam hospital	0
COL name VAL the ukrainian general staff	COL name VAL the ukrainian state	0
COL name VAL aounist trend	COL name VAL the aounist trend	1
COL name VAL human trafficking and moral protection bureau	COL name VAL human trafficking unit	0
COL name VAL imago mundi	COL name VAL umc rh	0
COL name VAL civi pol conseil	COL name VAL la cave	0
COL name VAL buccaneer britannia	COL name VAL elizabeth buckner	0
COL name VAL dow jones newswires	COL name VAL the dow jones	1
COL name VAL israeli public radio	COL name VAL israel radio	1
COL name VAL think forex	COL name VAL food tank the think tank for food	0
COL name VAL charlie hebdo magazine	COL name VAL charlie hebdo	1
COL name VAL the world monument fund britain	COL name VAL the world monuments fund	1
COL name VAL agoraleaks com	COL name VAL actuarial studies	0
COL name VAL the piccadilly theater	COL name VAL piccadilly theater	1
COL name VAL wisconsin project on nuclear arms control	COL name VAL the arms and security project	0
COL name VAL the senate select committee on intelligence	COL name VAL the permanent select committee on intelligence	1
COL name VAL the cohen group	COL name VAL the cohen kadosh group	1
COL name VAL structured finance	COL name VAL structured commodity finance	1
COL name VAL mahan travel and tourism sdn	COL name VAL samana travel and tourism	0
COL name VAL the middle east governors council	COL name VAL middle east council	1
COL name VAL al_ghad al_afdal foundation	COL name VAL the iyilikder foundation	0
COL name VAL oil refineries	COL name VAL the general association for oil refinery	0
COL name VAL the lebanon recovery fund	COL name VAL the lebanese recovery fund	1
COL name VAL the forum for the development of corporate identity	COL name VAL the indonesia development forum	0
COL name VAL the regional winterization plan	COL name VAL 9th wonder	0
COL name VAL partido popular	COL name VAL resistance bridades	0
COL name VAL the tripoli seafront company	COL name VAL le souverain	0
COL name VAL harvard kennedy school	COL name VAL the harvard kennedy school	1
COL name VAL roads and buildings	COL name VAL energy and buildings	0
COL name VAL tsc signature	COL name VAL the lebanese signature	0
COL name VAL zodiac group	COL name VAL the soteco group	0
COL name VAL the ashrafieh solidarity fund	COL name VAL lebanon solidarity fund	0
COL name VAL the committee on foreign investment in the united states	COL name VAL the united states senate committee on foreign relations	0
COL name VAL the society of petroleum engineers	COL name VAL the american society of civil engineers	0
COL name VAL egyptian initiative for personal rights	COL name VAL the egyptian decentralization initiative	0
COL name VAL office of foreign assets control	COL name VAL office of foreign asset control	1
COL name VAL the arab american news	COL name VAL american neos company	0
COL name VAL sixteen films	COL name VAL the daily suggester	0
COL name VAL the national youth policystakeholders	COL name VAL g 20 policies	0
COL name VAL search engine land	COL name VAL the zurich city court	0
COL name VAL the islamic unification movement	COL name VAL islamic nation unification party	0
COL name VAL mothers of love	COL name VAL mothers committee	0
COL name VAL jbeil committee	COL name VAL sub committee	0
COL name VAL piruseti enterprises ltd	COL name VAL kafak enterprises ltd	0
COL name VAL parler et revivre	COL name VAL youngs asian massage parlor	0
COL name VAL the aida cherfan gallery	COL name VAL aida cherfan fine art gallery	1
COL name VAL mikoko pamoja	COL name VAL bhumjai thai party	0
COL name VAL leadership education for asian pacifics shows	COL name VAL asian and pacific news agencies executive council	0
COL name VAL the catholic association for recovery in the near east	COL name VAL the association of roman catholics	0
COL name VAL emergency plan for aids relief	COL name VAL emergency and relief corps	0
COL name VAL golkar couture	COL name VAL gallagher nna	0
COL name VAL ecosystem development for small enterprise program	COL name VAL the advice for small business programme	0
COL name VAL league of the righteous	COL name VAL the league of the righteous	1
COL name VAL the kurdistan free life party	COL name VAL beirut guards	0
COL name VAL asharq al_awsat	COL name VAL ashraq al_awsat	1
COL name VAL performing arts hub	COL name VAL the university for music and performing arts	0
COL name VAL life and style magazine	COL name VAL life style	1
COL name VAL the algerian league for the defence of human rights	COL name VAL league of the righteous	0
COL name VAL tokyo electric power co	COL name VAL bir hasan tech	0
COL name VAL lockheed martin corp	COL name VAL lockheed martin	1
COL name VAL grand portage reservation	COL name VAL vivacity and prodigy	0
COL name VAL the diplomatic organization of security cooperation	COL name VAL the european security and cooperation organization	1
COL name VAL wine lab	COL name VAL the wine lab	1
COL name VAL yakiti party	COL name VAL t eacute l eacute	0
COL name VAL messengers of peace	COL name VAL facebook messenger	0
COL name VAL the ramadan charitable kitchen	COL name VAL the ramadan kitchen	1
COL name VAL le petit gris bistro	COL name VAL le petit gris	1
COL name VAL standards chartered bank	COL name VAL standard chartered group	0
COL name VAL nida al_watan	COL name VAL al_watan al_	0
COL name VAL trade in services on the internet advisory board	COL name VAL one service	0
COL name VAL association of owners and drivers	COL name VAL public drivers association	0
COL name VAL opera lebanon	COL name VAL uber lebanon	0
COL name VAL the breakthrough prize foundation	COL name VAL the booker prize foundation	0
COL name VAL the american society of health system pharmacists	COL name VAL university of pennsylvania health system	0
COL name VAL the national commission for the protection of the constitution and the law	COL name VAL the national committee for the protection of the constitution and the law	1
COL name VAL abdullatif fayyad school	COL name VAL abed al_latif fayad school	0
COL name VAL the liban cinema foundation	COL name VAL lebanon cinema foundation	0
COL name VAL the u s tennis association	COL name VAL francophone tennis association	0
COL name VAL maghie ghali hammana artist house	COL name VAL beeston hammana artist house	0
COL name VAL tag org 2022 improvement reformation and development	COL name VAL the national development and reform commission	0
COL name VAL rollingstones com	COL name VAL rolling stone	0
COL name VAL alliance of mediterranean news agencies	COL name VAL the association of mediterranean news agencies	1
COL name VAL london conference	COL name VAL the london conference	1
COL name VAL the beirut bar association on contempt proceedings in international criminal jurisdictions	COL name VAL jurists association	0
COL name VAL no garlic no onions	COL name VAL the no garlic no onions initiative	1
COL name VAL the san jose mercury news	COL name VAL sanayeh house	0
COL name VAL rwandan patriotic front	COL name VAL the patriotic socialist front	0
COL name VAL omega team	COL name VAL umc rh	0
COL name VAL visa lebanon	COL name VAL npa lebanon	0
COL name VAL the carnegie endowment	COL name VAL carnegie endowment	1
COL name VAL st luke hospital	COL name VAL st mary hospital	0
COL name VAL al_jazeera documentary	COL name VAL documenta 13	0
COL name VAL jabhat al_nusra	COL name VAL andjabhat al_nusra	1
COL name VAL pizza hut	COL name VAL pizza hut international	1
COL name VAL tanit gallery	COL name VAL galerie taniit	1
COL name VAL the national campaign to protect the bisri valley	COL name VAL the national campaign for the protection of migratory birds	0
COL name VAL people daily	COL name VAL the people daily	1
COL name VAL boubess group marketing director	COL name VAL pepsi co	0
COL name VAL pira energy group	COL name VAL china energy group	0
COL name VAL european friends of israel	COL name VAL friends of europe	0
COL name VAL j league	COL name VAL g league	0
COL name VAL the british embasy	COL name VAL the brirish embassy	1
COL name VAL the commonwealth war graves commission	COL name VAL commonwealth war graves commission	1
COL name VAL marshall plan foundation	COL name VAL the marshall plan	1
COL name VAL the attorneys syndicate	COL name VAL attorneys syndicate	1
COL name VAL standard chartered	COL name VAL standard chartered group	1
COL name VAL dai hulla co human dynamics	COL name VAL dinemec classics	0
COL name VAL j p avax	COL name VAL jp avax	1
COL name VAL hsbc bank middle east limited	COL name VAL the hsbc bank	0
COL name VAL the association of maritime agents	COL name VAL the association of war time allies	0
COL name VAL miramax films	COL name VAL the vlaams blok	0
COL name VAL the ahfad al_rasoul brigades	COL name VAL the ahfad al_rasoul battalion	0
COL name VAL henley and partners	COL name VAL shair and partners	0
COL name VAL antoine ticketing	COL name VAL takieddine group	0
COL name VAL children heart center	COL name VAL the children heart center	1
COL name VAL bono co	COL name VAL ray ban	0
COL name VAL the iraqi journalists union	COL name VAL the tunisian journalists union	0
COL name VAL the american society of health system pharmacists	COL name VAL health systems global	0
COL name VAL the st george yacht club	COL name VAL the st george yacht club gallery	1
COL name VAL the coordination and social action bureau	COL name VAL pierre cardin	0
COL name VAL the lebanese syndicate for poultry farmers	COL name VAL the lebanese poultry syndicate	1
COL name VAL the embrace fund	COL name VAL embrace fund	1
COL name VAL campus art dubai	COL name VAL la via campesina	0
COL name VAL compas austral	COL name VAL la via campesina	0
COL name VAL the beirut development council	COL name VAL board of development	0
COL name VAL the commonwealth realm	COL name VAL the caribbean commonwealth	0
COL name VAL transportation energy and hydraulic house	COL name VAL public works transportation energy and hydraulic resources house commission	0
COL name VAL tripoli city	COL name VAL triple c	0
COL name VAL the housing ministry	COL name VAL housing bank	0
COL name VAL makhzoumi nna	COL name VAL the makhzoumi centre	0
COL name VAL state oil and gas company	COL name VAL pars oil and gas company	1
COL name VAL the council of permanent delegates	COL name VAL the council of delegates	1
COL name VAL the national campaign for the prevention of cervical cancer	COL name VAL the lebanese cervical cancer prevention committee	0
COL name VAL the national committee for the centennial of greater lebanon	COL name VAL the state of greater lebanon	0
COL name VAL the ministry of investment	COL name VAL the investment ministry	1
COL name VAL grand factory	COL name VAL the grand factory	1
COL name VAL the academy of qibeh youth	COL name VAL the youth club	0
COL name VAL ecosystem development for small enterprise program	COL name VAL advice for small business programme	0
COL name VAL centre de lecture et d animation culturelle	COL name VAL audio kultur	0
COL name VAL the calvary baptist church	COL name VAL calvary church	1
COL name VAL washington movers international	COL name VAL washington institute	0
COL name VAL london stock exchange	COL name VAL the london metal exchange	0
COL name VAL nahhas appointments movement	COL name VAL u n appointed	0
COL name VAL small bear big heart	COL name VAL the small bear big heart	1
COL name VAL shell energy north america	COL name VAL the north american meat institute	0
COL name VAL u s drug enforcement agency	COL name VAL drug enforcement agency	1
COL name VAL priest of marjeioun greek orthodox parish	COL name VAL the orthodox parish of bsarma	0
COL name VAL f s a	COL name VAL u s a	0
COL name VAL the general fisheries commission for the mediterranean	COL name VAL bureau of fisheries	0
COL name VAL the al_marej organic food store	COL name VAL al_marej organic food	1
COL name VAL the federal democratic system of rojava	COL name VAL lions of rojava	0
COL name VAL the bloomberg initiative to reduce tobacco use	COL name VAL the bloomberg initiative	0
COL name VAL ers nifa	COL name VAL the quai d orsay	0
COL name VAL the national electrical utility company	COL name VAL national electrical utility	1
COL name VAL cyrus airways	COL name VAL cyprus airways	1
COL name VAL the tiraz museum	COL name VAL tiraz museum	1
COL name VAL the department of negotiations for conflicts	COL name VAL is negotiations	0
COL name VAL the hebrew university bible project	COL name VAL hebrew university	0
COL name VAL al_mustaqbal bloc	COL name VAL islamist bloc	0
COL name VAL hamburg port consulting	COL name VAL hamburg port	1
COL name VAL the moroccan office for hydrocarbons and mining	COL name VAL the hydrographic department	0
COL name VAL woodside petroleum ltd	COL name VAL woodside petroleum	1
COL name VAL al_mada radio	COL name VAL sawt el_mada radio	1
COL name VAL rizk hospital	COL name VAL the laumc rizk hospital	1
COL name VAL constitutional tribunal	COL name VAL the u n tribunal	0
COL name VAL zuwwar alimam ali al_reda	COL name VAL zuwwar al_imam ali al_	1
COL name VAL evening standard	COL name VAL evening lebanese	0
COL name VAL the committee against bird slaughter	COL name VAL raqqa is being slaughtered silently	0
COL name VAL xinhua news agency	COL name VAL the xinhua news agency	1
COL name VAL goldman sachs asset management	COL name VAL llb asset management	0
COL name VAL al_salam hospital	COL name VAL the saydet al_salam hospital	1
COL name VAL the north general security division	COL name VAL the state security division	0
COL name VAL the hiroshima peace memorial museum	COL name VAL the beirut war memorial museum	0
COL name VAL general services	COL name VAL the general security services	1
COL name VAL sgbl bank	COL name VAL ibl bank	0
COL name VAL conflict security and stability fund	COL name VAL conflict stability and security fund	1
COL name VAL apollo hospitals	COL name VAL de appel	0
COL name VAL turkey cyprus project	COL name VAL the turkey project	1
COL name VAL khiyam com	COL name VAL cma cgm	0
COL name VAL lazard gulf limited	COL name VAL financial advisory lazard	0
COL name VAL threat analysis group	COL name VAL third force	0
COL name VAL royal threads	COL name VAL cyber threatsdark	0
COL name VAL harb bureau	COL name VAL berri harb	0
COL name VAL the committee on commerce science and transportation	COL name VAL the senate commerce committee	0
COL name VAL the arab british centre starch foundation	COL name VAL starch foundation	0
COL name VAL the privatization and investment board	COL name VAL private criminal investigation	0
COL name VAL francophone affairs advisor	COL name VAL foreing affairs	0
COL name VAL tokyo electric	COL name VAL tokyo electric power co	0
COL name VAL total lebanon	COL name VAL sgbl lebanon	0
COL name VAL the dutch development bank	COL name VAL the saudi development bank	0
COL name VAL qalamoun media center	COL name VAL the qalamoun media center	1
COL name VAL the royal academy of scientific international trust	COL name VAL the royal academy of science international trust	1
COL name VAL the eparchy of saint maroun de montral	COL name VAL the maronite eparchy of baalbek	0
COL name VAL the media focal center	COL name VAL media focal center	1
COL name VAL mai dubai	COL name VAL zz top	0
COL name VAL pussy riot	COL name VAL bas nna	0
COL name VAL the keyrouz bakery	COL name VAL keyrouz bakery	1
COL name VAL the london metal exchange	COL name VAL london stock exchange	0
COL name VAL cub gallery	COL name VAL fdc gallery	0
COL name VAL rawda high school	COL name VAL st rita school	0
COL name VAL the contact group plan	COL name VAL contact group	1
COL name VAL the islamic center of mufreesboro	COL name VAL islamic center	1
COL name VAL center on conflict development and peacebuilding	COL name VAL the international dialogue on peacebuilding and statebuilding	0
COL name VAL beirut mayors league	COL name VAL la marsa	0
COL name VAL tanmiah chicken	COL name VAL tanmia chicken	1
COL name VAL environment quebec	COL name VAL environment and	1
COL name VAL the february 17 martyrs brigade	COL name VAL the february committee	0
COL name VAL guinness world records	COL name VAL the guinness book of world records	1
COL name VAL ottoman fourth army	COL name VAL the fourth part	0
COL name VAL iup iclp	COL name VAL iup icl	1
COL name VAL africa progress panel	COL name VAL the international panel on social progress	0
COL name VAL the trump foundation	COL name VAL the donald j trump foundation	0
COL name VAL loubnan al_mahaba al_ijtimaiya al_insaniya	COL name VAL al_nusra in lebanon	0
COL name VAL noble energy	COL name VAL u s noble energy company	0
COL name VAL household cavalry	COL name VAL the imperial household	0
COL name VAL atamian watches	COL name VAL church of loaves and fishes	0
COL name VAL deutsche bahn	COL name VAL deutsche bank	1
COL name VAL fridays for future and extinction rebellion	COL name VAL fridays for future	1
COL name VAL labors unions	COL name VAL courcelle labrousse	0
COL name VAL osama habib jammal trust bank	COL name VAL the jammal trust bank	1
COL name VAL al_anbaa magazine	COL name VAL anbaa online magazine	0
COL name VAL the cnam university	COL name VAL hannam university	0
COL name VAL ceramics n more	COL name VAL ceramics and more	1
COL name VAL invisible circus	COL name VAL miu miu s quirks	0
COL name VAL the national ideological resistance in syria	COL name VAL global center for combating extremist ideology	0
COL name VAL hikma pharmaceuticals	COL name VAL turing pharmaceuticals	0
COL name VAL the hilton hotels resorts media center	COL name VAL starwood hotels and resorts	0
COL name VAL a maritime security center	COL name VAL the international maritime security construct	0
COL name VAL our lady of perpetual help school	COL name VAL our lady of good help church	0
COL name VAL pakistan international airlines	COL name VAL ukrainian international airlines	0
COL name VAL church of scientology	COL name VAL the church of scientology	1
COL name VAL the dubai airports	COL name VAL tibah airports development	0
COL name VAL european convention for the protection of human rights and fundamental freedoms	COL name VAL the european court of human rights	0
COL name VAL dar al_handasah shair and partners	COL name VAL dar al_handasah shair partners	1
COL name VAL shumoukh al_islam	COL name VAL shmoukh al_islam	1
COL name VAL the otolith group	COL name VAL media outlets	0
COL name VAL protocol department	COL name VAL the protected areas department	0
COL name VAL the u s conference of catholic bishops	COL name VAL the nicaraguan catholic bishops conference	0
COL name VAL the plaza de mayo	COL name VAL mothers of the plaza de mayo	1
COL name VAL altcity impact	COL name VAL impact lebanon impactlebanon	0
COL name VAL lashkar e jhangvi	COL name VAL zhongfa group	0
COL name VAL ahrar al	COL name VAL ahrar al_sunna	0
COL name VAL barry callebaut	COL name VAL harlem globetrotters	0
COL name VAL imet program	COL name VAL le progres	0
COL name VAL rafael advanced defense systems ltd	COL name VAL advanced energy systems ades sae	0
COL name VAL psp cultural center	COL name VAL the sawab centre	0
COL name VAL global investment house kscc	COL name VAL global investment house	1
COL name VAL new horizons afaq	COL name VAL new horizons al_jadid	0
COL name VAL mng maritime	COL name VAL lady maritime	0
COL name VAL 10 downing street	COL name VAL raad auto tuning	0
COL name VAL army of conquest	COL name VAL the l a kings	0
COL name VAL hezbollah brigades	COL name VAL pro hezbollah resistance brigades	0
COL name VAL our lady of balamand patriarchal monastery	COL name VAL the lady of balamand high school	0
COL name VAL central laboratory	COL name VAL the beirut central laboratory	1
COL name VAL the union of concerned scientists	COL name VAL union congress	0
COL name VAL islamic tawhid	COL name VAL the islamic tawhid party	1
COL name VAL hualong one	COL name VAL coca cola hellenic bottling co	0
COL name VAL the jawad center for development and agricultural guidance	COL name VAL the agricultural center	0
COL name VAL the pontifical council for the pastoral care of immigrants and itinerants	COL name VAL the pontifical council for the pastoral health services	0
COL name VAL the portland group	COL name VAL brattle group	0
COL name VAL the fondazione nicola del roscio	COL name VAL fed funds	0
COL name VAL beyond learning	COL name VAL the learning center	0
COL name VAL sleiman sleiman	COL name VAL sleiman u k	0
COL name VAL darkside babel theater	COL name VAL babel theatre	1
COL name VAL the ecole normale superieure	COL name VAL the ecole superieure d optometrie	0
COL name VAL the together for missing persons association	COL name VAL the together we can run association	0
COL name VAL dairy d	COL name VAL dairy day	0
COL name VAL the muslim public affairs council	COL name VAL public affairs	0
COL name VAL the st george yacht club	COL name VAL the st georges hotel and yacht club	0
COL name VAL usr plus	COL name VAL the plaza de mayo	0
COL name VAL the valuable girl project	COL name VAL phellipolis committee	0
COL name VAL lopsided historypergamon	COL name VAL the maine lobstermen association	0
COL name VAL the royal society for the protection of birds	COL name VAL royal society for the conservation of nature	0
COL name VAL the smithsonian magazine	COL name VAL the smithsonian institute	0
COL name VAL attorneys house	COL name VAL the attorney house	1
COL name VAL sun studios	COL name VAL green studios	0
COL name VAL national investment commission	COL name VAL the baghdad investment commission	0
COL name VAL zhejiang cb	COL name VAL zhejiang petrochemical	0
COL name VAL the rapid response	COL name VAL rapid response forces	1
COL name VAL the safe building alliance international	COL name VAL the safe buildings association	0
COL name VAL the international bar leaders senate	COL name VAL g 20 leaders	0
COL name VAL the lebanese union for horse riding	COL name VAL the lebanese union for skiing	0
COL name VAL the national institute of food and agriculture	COL name VAL the council of the food and agriculture organization	0
COL name VAL al_haqq and ansar al_sham brigades	COL name VAL ansar unit	0
COL name VAL ion geophysical	COL name VAL the u s geophysical institute	0
COL name VAL mitsubishi hitachi power systems	COL name VAL aub headache clinic	0
COL name VAL the malankara church	COL name VAL catholic melenkart church	0
COL name VAL the cedar lounge	COL name VAL u lounge bar	0
COL name VAL assembly of experts	COL name VAL the assembly of experts	1
COL name VAL the arabic and near eastern languages department	COL name VAL the world council for arabic language	0
COL name VAL washington institute for near east policy	COL name VAL the washington institute	0
COL name VAL vorderasiatischen museums	COL name VAL qatar museums	0
COL name VAL ab inbev	COL name VAL anheuser busch inbev	0
COL name VAL new york yankeesjersey	COL name VAL the new york yankees	0
COL name VAL the independence party	COL name VAL the united kingdom independence party	0
COL name VAL the lindt chocolat cafe	COL name VAL the salon du chocolat	0
COL name VAL the economy and commerce ministries	COL name VAL the commerce ministry	1
COL name VAL the regiment of aisha mother of the faithful	COL name VAL the faithful nuns	0
COL name VAL the third temple	COL name VAL third temple	1
COL name VAL the cite des arts	COL name VAL jeunes artistes des beaux arts du liban	0
COL name VAL huffington post celebrity	COL name VAL the huffington post canada	0
COL name VAL the yellow movement	COL name VAL yellow pay	0
COL name VAL trump international hotel	COL name VAL the trump international hotel	1
COL name VAL the safe buildings association	COL name VAL the building construction association	0
COL name VAL u s a	COL name VAL k s a	0
COL name VAL jub jennin	COL name VAL jeb jennin	0
COL name VAL jubilee school	COL name VAL the jubilee school	1
COL name VAL the association of gulf jewish communities	COL name VAL the jewish community of the emirates	0
COL name VAL hard rock cafe	COL name VAL the bay rock cafe	0
COL name VAL safir heliopolis	COL name VAL heliopolis cooperative	0
COL name VAL exxon company	COL name VAL the hassan ayash exchange company	0
COL name VAL quatuor musique del tempo	COL name VAL the qadiriyya mosque	0
COL name VAL medical affairs	COL name VAL medical aid	0
COL name VAL the new people party	COL name VAL the people action party	0
COL name VAL the iaa global	COL name VAL s p global	0
COL name VAL the multilateral investment guarantee agency	COL name VAL multilateral insurance guarantee agency	1
COL name VAL bbc radio 4 today programme	COL name VAL bbc radio 5 live	0
COL name VAL the franco german european corps	COL name VAL the german dutch corps	0
COL name VAL the science and technology advisory council of the president of egypt	COL name VAL national council of science and technology	0
COL name VAL al_jadeed news	COL name VAL al_jadeed co	0
COL name VAL global post	COL name VAL la poste	0
COL name VAL usaifa international limited	COL name VAL kafak enterprises limited	0
COL name VAL road and urban development	COL name VAL the red sea development co	0
COL name VAL the erlangen centre for islam and law	COL name VAL the erlangen center for islam and law in europe	1
COL name VAL union of armenian evangelical churches	COL name VAL the union of the armenian evangelical churches in the near east	0
COL name VAL blue and white	COL name VAL the blue and white	1
COL name VAL the akkar governorate crisis cell	COL name VAL the central crisis cell	0
COL name VAL people action party	COL name VAL the people action party	1
COL name VAL world duty free group	COL name VAL our world in data	0
COL name VAL the february 20 movement	COL name VAL february 17 brigade	0
COL name VAL lebanese treasury	COL name VAL lebanese pound treasury	1
COL name VAL liu crushes	COL name VAL aub crushes	0
COL name VAL the banipal trust	COL name VAL the banipal trust for arab literature	0
COL name VAL arabica group tv	COL name VAL arabica tv board	0
COL name VAL the national clean air programme	COL name VAL kenn borek air	0
COL name VAL u n action against sexual violence in conflict	COL name VAL association of media against violence	0
COL name VAL moroccan embassy	COL name VAL the moroccan embassy	1
COL name VAL the canada fund for local initiatives	COL name VAL the elsie initiative fund	0
COL name VAL g global	COL name VAL tag global	0
COL name VAL shahid sanikhani industries	COL name VAL shahid kharrazi industries	0
COL name VAL ita beirut office	COL name VAL eid beirut	0
COL name VAL the badawi group	COL name VAL badawi group	1
COL name VAL the alaska energy authority	COL name VAL the wyoming energy authority	0
COL name VAL the american boards in palliative care	COL name VAL palliative care unit	0
COL name VAL mena affairs	COL name VAL unrwa affairs	0
COL name VAL boutique wineries	COL name VAL karam wineries	0
COL name VAL the bolshoi ballet in cinema	COL name VAL bolshoi ballet	0
COL name VAL performing arts hub	COL name VAL the lebanese association for the development and performance of arts	0
COL name VAL safe borders project	COL name VAL the border control project	0
COL name VAL centacle de la lumiere	COL name VAL cenacle de la lumiere	1
COL name VAL the bo shop	COL name VAL the body shop	1
COL name VAL belent asgabat	COL name VAL great escape	0
COL name VAL zuwwar al_imam ali al_	COL name VAL saraya alwiya al_	0
COL name VAL samana travel and tourism	COL name VAL mahan travel and tourism sdn	0
COL name VAL the national marine fisheries service	COL name VAL fisheries and oceans canada	0
COL name VAL the observatory on food and migration	COL name VAL u n migration	0
COL name VAL the order of midwives	COL name VAL starcom mediavest	0
COL name VAL ziad ben sultan al_nahyan institution for humanitarian deeds	COL name VAL ziad ben sultan al_nahyan	0
COL name VAL chrisfader d b h	COL name VAL grozev dobreva	0
COL name VAL the martyrs museum	COL name VAL the qana martyrs museum	1
COL name VAL the british embassay	COL name VAL the brirish embassy	1
COL name VAL a antoine	COL name VAL antoine s a l	0
COL name VAL guangdong southern tigers	COL name VAL lugano tigers	0
COL name VAL the uruguay public school	COL name VAL the eimar public school	0
COL name VAL nabatieh rammal restaurant	COL name VAL nabatieh nna	0
COL name VAL february 17 brigade	COL name VAL the february committee	0
COL name VAL gulf online	COL name VAL ahram online	0
COL name VAL iraq agro food	COL name VAL the agro food syndicate	0
COL name VAL the green mind association	COL name VAL green mind ngo	0
COL name VAL plantation industries and commodities	COL name VAL the institute of plant industry	0
COL name VAL frente polisario	COL name VAL polisario front	1
COL name VAL the network for the promotion of asian pacific cinema	COL name VAL leadership education for asian pacifics shows	0
COL name VAL kayssar atta	COL name VAL la closerie	0
COL name VAL the brazilian navy	COL name VAL brazilian navy	1
COL name VAL emirates airline and group	COL name VAL the emirates group	1
COL name VAL ebrd tfp	COL name VAL x apartments	0
COL name VAL shebaa farms	COL name VAL the committee of arqoub and shebaa farms	0
COL name VAL electronic army	COL name VAL the syrian electronic army	1
COL name VAL sputnik v	COL name VAL sputnik international	0
COL name VAL the basel convention on the control of transboundary movements of hazardous waste and their disposal	COL name VAL huai an hazardous goods transport co	0
COL name VAL the committee to protect tenants rights	COL name VAL the committee to protect civilians	0
COL name VAL baalbeck hermel gov	COL name VAL baalbeck hermel mufti	0
COL name VAL the united world college dilijian	COL name VAL united world colleges	0
COL name VAL the national steering committee against child labor	COL name VAL the global march against child labor	0
COL name VAL strategic foresight group	COL name VAL first bristol group	0
COL name VAL baalbek hermel choice	COL name VAL baalbeck hirmel	1
COL name VAL marvel studios	COL name VAL wixel studios	0
COL name VAL the national ict strategy	COL name VAL national agoa strategy	0
COL name VAL g d currency technology	COL name VAL guernica 37	0
COL name VAL unc rex healthcare	COL name VAL ghobeiry healthcare center	0
COL name VAL sovereign front	COL name VAL the sovereign front	1
COL name VAL the parliamentary group of the islamic states	COL name VAL islamic parliaments	0
COL name VAL the south ii program	COL name VAL euromed pprd south ii program	1
COL name VAL the thermal tyre factory	COL name VAL al_zahrani thermal plant	0
COL name VAL international pharmacists league	COL name VAL arab pharmacists league	0
COL name VAL rp leipzig	COL name VAL lipscomb university	0
COL name VAL bab amr martyrs battalion	COL name VAL the ain al_hilweh martyrs battalion	0
COL name VAL metropolis cinema association	COL name VAL metropolis cinemas sofil	0
COL name VAL kassem rmeiti co	COL name VAL kassem rmeiti co for exchange	1
COL name VAL the civil lebanon document project	COL name VAL documenta 13	0
COL name VAL anti rebel	COL name VAL the mainstream rebel	0
COL name VAL 392rmeil393 gallery	COL name VAL 392 rmeil 393 gallery	0
COL name VAL the ibc municipal solid waste treatment center	COL name VAL the municipal solid waste treatment center	1
COL name VAL the led drummers	COL name VAL the toromoro press agency	0
COL name VAL mediterranean hope	COL name VAL mediterranean nna	0
COL name VAL serta channels	COL name VAL christian tv channels	0
COL name VAL the know nothings	COL name VAL the know nothing party	1
COL name VAL the washington institute for near eastern policy	COL name VAL the washington institute	0
COL name VAL quality control laboratories	COL name VAL the central laboratory	1
COL name VAL koon theater group	COL name VAL the koon theater group	1
COL name VAL banque du liban circular no	COL name VAL central bank circular 137	0
COL name VAL the john gerhart center	COL name VAL gerard nna	0
COL name VAL the university of pennsylvania	COL name VAL university of pennsylvania health system	1
COL name VAL dar al_zahraa associations	COL name VAL al_nidaa association	0
COL name VAL the senior scholars council	COL name VAL the senior ulama council	0
COL name VAL tadamun solidarity party	COL name VAL tadamon sour	0
COL name VAL the legal agenda ngo	COL name VAL the legal agenda	1
COL name VAL vine lab	COL name VAL the wine lab	1
COL name VAL independent culture	COL name VAL ettijihat independent culture	1
COL name VAL sarba barhoush	COL name VAL sarba nna	0
COL name VAL global burden of diseases injuries and risk factors study	COL name VAL the global partners governance	0
COL name VAL toyota motor co	COL name VAL toyota motor corp	1
COL name VAL religious authority	COL name VAL religious endowments authority	1
COL name VAL vrt network	COL name VAL art networks	0
COL name VAL saraya al_	COL name VAL saraya ahl al_	1
COL name VAL arab financial support	COL name VAL arab finance house	0
COL name VAL office for rehabilitation	COL name VAL the kuwait fund for the rehabilitation	0
COL name VAL u n chartered	COL name VAL la t shirterie	0
COL name VAL air china	COL name VAL air china ltd	1
COL name VAL l oreal	COL name VAL l oreal uk	1
COL name VAL the arwan pharmaceutical industries company	COL name VAL arwan pharmaceutical company	1
COL name VAL the muslim shabab	COL name VAL muslim shabab	1
COL name VAL the border police	COL name VAL the border patrol	0
COL name VAL films femmes francophones mediterranee	COL name VAL film femmes francophones mediterranean	1
COL name VAL we are handsome	COL name VAL huntsworth group	0
COL name VAL downing center district court	COL name VAL the downing center district court	1
COL name VAL the ndu choir	COL name VAL the nmc choir	0
COL name VAL the zaitunay bay beirut yacht club	COL name VAL yakiti party	0
COL name VAL philadelphia university	COL name VAL sal flat6labs	0
COL name VAL february 17 brigade	COL name VAL the february forces	0
COL name VAL the national change current	COL name VAL change committee	0
COL name VAL the center for new structural economics	COL name VAL the council of the institute of new structural economics	0
COL name VAL beirut waterfront development company	COL name VAL waterfront city	0
COL name VAL the tiraz museum	COL name VAL the iraq museum	1
COL name VAL the university for music and performing arts	COL name VAL performing arts center	0
COL name VAL the union of drug importers	COL name VAL union of books importers	1
COL name VAL the united kingdom marine trade operations	COL name VAL united kingdom marine trade operations	1
COL name VAL the yellow movement	COL name VAL yellow movement	1
COL name VAL weill cornell newyork presbyterian hospital	COL name VAL weill cornell	0
COL name VAL the association of importers of ceramic and porcelain tiles	COL name VAL ceramics and more	0
COL name VAL the guggenheim museum	COL name VAL guggenheim partners	0
COL name VAL the ninevah museum	COL name VAL ninevah governorate	0
COL name VAL the lebanese media group	COL name VAL the lebanese amb group	0
COL name VAL as diyar	COL name VAL ad diyar	0
COL name VAL the union of importers of books	COL name VAL le bacchus	0
COL name VAL the king abdullah university of science and technology	COL name VAL king abdullah university of science and technology	1
COL name VAL liliwhite weddings	COL name VAL wedding folies	0
COL name VAL industrial light magic	COL name VAL the magic lantern	0
COL name VAL the central committee of the union of armenian evangelical churches	COL name VAL the union of armenian evangelical churches in the near east	0
COL name VAL the supporters of the islamic caliphate	COL name VAL the islamic caliphate	1
COL name VAL the modern theater	COL name VAL the beirut school for modern theater	0
COL name VAL real estate weekly	COL name VAL sports weekly	0
COL name VAL a crisis cell	COL name VAL the ministerial crisis cell	0
COL name VAL personal protection equipment	COL name VAL the equipment development department	0
COL name VAL sukhoi 24	COL name VAL sukhoi 33	0
COL name VAL europol gaz	COL name VAL erbil sc	0
COL name VAL friendship caucus	COL name VAL eni kogas	0
COL name VAL bshamoun specialty hospital	COL name VAL bshamoun hospital	1
COL name VAL rasamny younis motor company	COL name VAL rasamny younis motors	0
COL name VAL the elderly house	COL name VAL elderly house	1
COL name VAL saham finances	COL name VAL saham finances sal	1
COL name VAL new fifa now	COL name VAL new wave	0
COL name VAL malaysianal jazeera	COL name VAL malaysian armed forces	0
COL name VAL the daily star sports weekly	COL name VAL us weekly	0
COL name VAL the northern command	COL name VAL u s northern command	0
COL name VAL shabab ahed	COL name VAL shbib nna	0
COL name VAL al_aqsa tv	COL name VAL al_aqsa u s	0
COL name VAL the cnrs l	COL name VAL the cnrs l h e	0
COL name VAL a truth and dignity commission	COL name VAL the truth and dignity commission	1
COL name VAL unrwa lebanon filed office	COL name VAL field office	0
COL name VAL the international friends of richard wagner society	COL name VAL the wagner group	0
COL name VAL shahid sanikhani industries	COL name VAL shahid shustari industries	0
COL name VAL ifi aub	COL name VAL aub ifi	1
COL name VAL the general hermel farmers cooperative	COL name VAL the hermel cooperatives union	0
COL name VAL the heart and vascular clinical center of excellence	COL name VAL debakey heart and vascular center	0
COL name VAL pharma dynamics	COL name VAL dinemec classics	0
COL name VAL take back the tech	COL name VAL tag bc	0
COL name VAL al_bustan festival office	COL name VAL the festival office	1
COL name VAL electronic army	COL name VAL syrian electronic army	1
COL name VAL directors guild of america	COL name VAL directors guild	1
COL name VAL moscow mule	COL name VAL moscow hospital no	0
COL name VAL the magna carta fund for human rights and democracy	COL name VAL the democracy fund	0
COL name VAL the operation big blue association	COL name VAL operation big blue	1
COL name VAL atom bank	COL name VAL am bank	0
COL name VAL the british treasury	COL name VAL british treasury	1
COL name VAL qabbani association	COL name VAL ghadi association	0
COL name VAL palliative care unit	COL name VAL center for palliative care	0
COL name VAL democratic left alliance	COL name VAL the democratic left	1
COL name VAL the council of american islamic relations	COL name VAL council on american islamic relations	1
COL name VAL sakson group	COL name VAL non group	0
COL name VAL hair dreams beauty lounge	COL name VAL the art lounge	0
COL name VAL american rewards for justice	COL name VAL rewards for justice	1
COL name VAL rainbow warrior	COL name VAL rainbow nation	0
COL name VAL the inclusive decisions for equal and accountable society ideas project	COL name VAL free decision	0
COL name VAL washington office on latin america	COL name VAL washington institute	0
COL name VAL red bull bc one lebanon cypher	COL name VAL bbc radio 4	0
COL name VAL im ventures	COL name VAL leap ventures	0
COL name VAL the garden show festival	COL name VAL le chef	0
COL name VAL fbme bank ltd	COL name VAL the fpm party	0
COL name VAL air sinai	COL name VAL the euro zone	0
COL name VAL family protection department	COL name VAL civil protection department	0
COL name VAL daraj al_azarieh	COL name VAL daraj com	0
COL name VAL the lebanese association for an efficient civil society	COL name VAL lebanese civil society	0
COL name VAL aub ifi	COL name VAL ifi aub	1
COL name VAL argentina project	COL name VAL the argentinian army	0
COL name VAL the american society of animal science	COL name VAL the american society of agronomy	0
COL name VAL five power defense arrangements	COL name VAL orange s a	0
COL name VAL mentor arabia friends	COL name VAL mentor arabia	1
COL name VAL close naameh landfill	COL name VAL close the naameh landfill campaign	1
COL name VAL the french secular mission	COL name VAL the french secular	1
COL name VAL ali express	COL name VAL dhl express	0
COL name VAL modern institution	COL name VAL the modern war institute	1
COL name VAL the world association of major metropolises	COL name VAL the metropolis association	0
COL name VAL the national measurement office	COL name VAL the national audit office	0
COL name VAL the harvard advanced leadership initiative	COL name VAL the advance student scholarship initiative	0
COL name VAL the embassy of pakistan	COL name VAL the embassy of japan	0
COL name VAL the voice kids	COL name VAL voice kids	1
COL name VAL tadamon sur	COL name VAL tadamoun sour	1
COL name VAL a just russia	COL name VAL just security	0
COL name VAL oil installations	COL name VAL zahrani oil installations	1
COL name VAL lf leader	COL name VAL la lettura	0
COL name VAL le vendome hotel	COL name VAL le vendome	1
COL name VAL tacos arabes	COL name VAL airbus se	0
COL name VAL the woodrow wilson international center for scholars	COL name VAL woodrow wilson school	0
COL name VAL salafist al_nour brigades	COL name VAL al_nour brigades	1
COL name VAL mist hotel spa ehden	COL name VAL the eden hotel	0
COL name VAL notre dame louaize school	COL name VAL the notre dame law school	1
COL name VAL high negotiating council	COL name VAL high negotiations council	1
COL name VAL hsbc switzerland	COL name VAL the european union of coptic organisations switzerland	0
COL name VAL nsw police	COL name VAL the nsw police	1
COL name VAL drugs and pharmaceuticals	COL name VAL meivo pharmaceuticals	0
COL name VAL baalbeck hirmel	COL name VAL directorate of baalbek hermel	1
COL name VAL akademie der kunst	COL name VAL haus der kunst	0
COL name VAL the xinhua news agency	COL name VAL xinhua agency	1
COL name VAL the hochscule fur bildende kunste	COL name VAL the building construction association	0
COL name VAL the mohammad v university	COL name VAL the university of mohammed v rabat	1
COL name VAL multilateral investment guarantee agency	COL name VAL multilateral development	0
COL name VAL martyrs battalion	COL name VAL the martyr tamer awwam battalion	0
COL name VAL the rand corp	COL name VAL renta 4	0
COL name VAL ansar bayt al_maqdis	COL name VAL ansar beit el_maqdas	0
COL name VAL ngo online collaborative	COL name VAL the online collaborative	1
COL name VAL visa d or daily press	COL name VAL the daily wire	0
COL name VAL the national immigrant justice center	COL name VAL the national immigration law center	1
COL name VAL the world society for the protection of animals	COL name VAL the international organisation for the protection of animals	0
