COL name VAL ivar y  nørve	COL name VAL ivar nørve	1
COL name VAL tore c. heyerdahl	COL name VAL tore heyerdahl	1
COL name VAL tore k  heyerdahl	COL name VAL tore heyerdahl	1
COL name VAL peter e. bredal	COL name VAL peter bredal	1
COL name VAL ingeborg j  finnsdóttir	COL name VAL ingeborg finnsdóttir	1
COL name VAL ingeborg c. finnsdóttir	COL name VAL ingeborg finnsdóttir	1
COL name VAL ingeborg t. finnsdóttir	COL name VAL ingeborg finnsdóttir	1
COL name VAL ivar a  nordkild	COL name VAL ivar nordkild	1
COL name VAL andrew a. stoltenberg	COL name VAL andrew stoltenberg	1
COL name VAL andrew b. stoltenberg	COL name VAL andrew stoltenberg	1
COL name VAL astrid m. johannessen	COL name VAL astrid johannessen	1
COL name VAL vlasta c. vrána	COL name VAL vlasta vrána	1
COL name VAL werner c  christie	COL name VAL werner christie	1
COL name VAL bjørn j. heyerdahl	COL name VAL bjørn heyerdahl	1
COL name VAL bjørn d. heyerdahl	COL name VAL bjørn heyerdahl	1
COL name VAL øystein j. halfdansson	COL name VAL øystein halfdansson	1
COL name VAL eystein s  halfdansson	COL name VAL eystein halfdansson	1
COL name VAL øystein r  halfdansson	COL name VAL øystein halfdansson	1
COL name VAL eystein d. halfdansson	COL name VAL eystein halfdansson	1
COL name VAL øystein c  halfdansson	COL name VAL øystein halfdansson	1
COL name VAL eystein d  halfdansson	COL name VAL eystein halfdansson	1
COL name VAL arne a. røed	COL name VAL arne røed	1
COL name VAL arne t  røed	COL name VAL arne røed	1
COL name VAL arne a  røed	COL name VAL arne røed	1
COL name VAL camillo d  everardi	COL name VAL camillo everardi	1
COL name VAL camille y  everardi	COL name VAL camille everardi	1
COL name VAL alexandra c  joner	COL name VAL alexandra joner	1
COL name VAL solfrid h  heier	COL name VAL solfrid heier	1
COL name VAL christophe s  schatteman	COL name VAL christophe schatteman	1
COL name VAL erik r. schjerven	COL name VAL erik schjerven	1
COL name VAL gard n  eidsvold	COL name VAL gard eidsvold	1
COL name VAL bjørnstjerne r  eidsvold	COL name VAL bjørnstjerne eidsvold	1
COL name VAL harry f. lien	COL name VAL harry lien	1
COL name VAL olaf e  tryggvason	COL name VAL olaf tryggvason	1
COL name VAL victor r. verschueren	COL name VAL victor verschueren	1
COL name VAL paulette e  cooper	COL name VAL paulette cooper	1
COL name VAL august n. olsen	COL name VAL august olsen	1
COL name VAL cecilie e. mosli	COL name VAL cecilie mosli	1
COL name VAL cecilie i. mosli	COL name VAL cecilie mosli	1
COL name VAL sondre l  tronstad	COL name VAL sondre tronstad	1
COL name VAL truls h. korsæth	COL name VAL truls korsæth	1
COL name VAL truls m. korsæth	COL name VAL truls korsæth	1
COL name VAL truls a. korsæth	COL name VAL truls korsæth	1
COL name VAL tone b. lima	COL name VAL tone lima	1
COL name VAL ingrid r. wold	COL name VAL ingrid wold	1
COL name VAL henning c. olsen	COL name VAL henning olsen	1
COL name VAL magnus d. eriksson	COL name VAL magnus eriksson	1
COL name VAL maunu t  eriksson	COL name VAL maunu eriksson	1
COL name VAL magnus g. eriksson	COL name VAL magnus eriksson	1
COL name VAL maunu w. eriksson	COL name VAL maunu eriksson	1
COL name VAL øystein p  magnusson	COL name VAL øystein magnusson	1
COL name VAL eysteinn r  magnusson	COL name VAL eysteinn magnusson	1
COL name VAL sigurd m. munn	COL name VAL sigurd munn	1
COL name VAL sigurd c. munn	COL name VAL sigurd munn	1
COL name VAL sigurd e  munn	COL name VAL sigurd munn	1
COL name VAL gunnbjörn p. ulfsson	COL name VAL gunnbjörn ulfsson	1
COL name VAL stéphanie l. van vyve	COL name VAL stéphanie van vyve	1
COL name VAL vivian w. miessen	COL name VAL vivian miessen	1
COL name VAL arnt r. grønbech	COL name VAL arnt grønbech	1
COL name VAL jarl m  goli	COL name VAL jarl goli	1
COL name VAL arnaud j. borchgrave	COL name VAL arnaud borchgrave	1
COL name VAL arnoud a  de meyer	COL name VAL arnoud de meyer	1
COL name VAL albert k. blanc	COL name VAL albert blanc	1
COL name VAL john r. robson	COL name VAL john robson	1
COL name VAL ivan t. robson	COL name VAL ivan robson	1
COL name VAL john c. robson	COL name VAL john robson	1
COL name VAL ivan j  robson	COL name VAL ivan robson	1
COL name VAL john k. robson	COL name VAL john robson	1
COL name VAL ivan j. robson	COL name VAL ivan robson	1
COL name VAL lise k  nøstvold	COL name VAL lise nøstvold	1
COL name VAL lise v. nøstvold	COL name VAL lise nøstvold	1
COL name VAL lise a  nøstvold	COL name VAL lise nøstvold	1
COL name VAL kari n  grønsund	COL name VAL kari grønsund	1
COL name VAL håkon r. ericsson	COL name VAL håkon ericsson	1
COL name VAL eystein l. magnusson	COL name VAL eystein magnusson	1
COL name VAL øivind a  blunck	COL name VAL øivind blunck	1
COL name VAL magnus g  barfod	COL name VAL magnus barfod	1
COL name VAL ragnhild w  mikkelsen	COL name VAL ragnhild mikkelsen	1
COL name VAL helene t. goudin	COL name VAL helene goudin	1
COL name VAL claire d  goudin	COL name VAL claire goudin	1
COL name VAL henry n. van den bulcke	COL name VAL henry van den bulcke	1
COL name VAL jozef g. roey	COL name VAL jozef roey	1
COL name VAL ernest m  roey	COL name VAL ernest roey	1
COL name VAL jozef l. roey	COL name VAL jozef roey	1
COL name VAL ernest v  roey	COL name VAL ernest roey	1
COL name VAL liv l. løberg	COL name VAL liv løberg	1
COL name VAL liv g  løberg	COL name VAL liv løberg	1
COL name VAL liv j  løberg	COL name VAL liv løberg	1
COL name VAL stian j. ringstad	COL name VAL stian ringstad	1
COL name VAL ánde f  somby	COL name VAL ánde somby	1
COL name VAL a. j. westgard	COL name VAL a. westgard	1
COL name VAL siri m. nordby	COL name VAL siri nordby	1
COL name VAL siri f. nordby	COL name VAL siri nordby	1
COL name VAL ole p. halvorsen	COL name VAL ole halvorsen	1
COL name VAL yurii m. luhovyj	COL name VAL yurii luhovyj	1
COL name VAL yurii d  luhovyj	COL name VAL yurii luhovyj	1
COL name VAL yurii d. luhovyj	COL name VAL yurii luhovyj	1
COL name VAL henrik j. bjørdal	COL name VAL henrik bjørdal	1
COL name VAL ole m  skjelbred-knutsen	COL name VAL ole skjelbred-knutsen	1
COL name VAL henri j. van den bulcke	COL name VAL henri van den bulcke	1
COL name VAL harald m. paalgard	COL name VAL harald paalgard	1
COL name VAL bente r. nordby	COL name VAL bente nordby	1
COL name VAL titti h. maartmann	COL name VAL titti maartmann	1
COL name VAL engelbert m. sterckx	COL name VAL engelbert sterckx	1
COL name VAL engelbert f  sterckx	COL name VAL engelbert sterckx	1
COL name VAL kim r  huybrechts	COL name VAL kim huybrechts	1
COL name VAL martin j. torp	COL name VAL martin torp	1
COL name VAL pierre l. lagrange	COL name VAL pierre lagrange	1
COL name VAL johan r  schwartz	COL name VAL johan schwartz	1
COL name VAL eline a  brustad	COL name VAL eline brustad	1
COL name VAL petter k. strand	COL name VAL petter strand	1
COL name VAL aryan d. tari	COL name VAL aryan tari	1
COL name VAL carlos c  cañas	COL name VAL carlos cañas	1
COL name VAL guri j  schanke	COL name VAL guri schanke	1
COL name VAL annika m. schanke	COL name VAL annika schanke	1
COL name VAL frøydis m  wærsted	COL name VAL frøydis wærsted	1
COL name VAL frøydis s  wærsted	COL name VAL frøydis wærsted	1
COL name VAL frøydis m  wærsted	COL name VAL frøydis wærsted	1
COL name VAL hugo m  munthe-kaas	COL name VAL hugo munthe-kaas	1
COL name VAL kjetil j  try	COL name VAL kjetil try	1
COL name VAL amélie d. rorty	COL name VAL amélie rorty	1
COL name VAL amélie p. rorty	COL name VAL amélie rorty	1
COL name VAL arne f  eggum	COL name VAL arne eggum	1
COL name VAL lage c. lund	COL name VAL lage lund	1
COL name VAL alain j. dehaze	COL name VAL alain dehaze	1
COL name VAL francisco p. cereijo	COL name VAL francisco cereijo	1
COL name VAL francisco j  cereijo	COL name VAL francisco cereijo	1
COL name VAL joaquín p  cañas	COL name VAL joaquín cañas	1
COL name VAL marcel j  fässler	COL name VAL marcel fässler	1
COL name VAL daniel w. müller	COL name VAL daniel müller	1
COL name VAL ditlev s. vibe	COL name VAL ditlev vibe	1
COL name VAL peder t  andersen	COL name VAL peder andersen	1
COL name VAL mina s. holtmann	COL name VAL mina holtmann	1
COL name VAL mina a. holtmann	COL name VAL mina holtmann	1
COL name VAL fredrik i. galta	COL name VAL fredrik galta	1
COL name VAL anke b  vanhooren	COL name VAL anke vanhooren	1
COL name VAL antonio j. suñol	COL name VAL antonio suñol	1
COL name VAL antonio l. suñol	COL name VAL antonio suñol	1
COL name VAL antonio c  suñol	COL name VAL antonio suñol	1
COL name VAL antonio w  suñol	COL name VAL antonio suñol	1
COL name VAL gustavo f. fernández	COL name VAL gustavo fernández	1
COL name VAL valeria m  pacheco	COL name VAL valeria pacheco	1
COL name VAL óscar f  vizcaíno	COL name VAL óscar vizcaíno	1
COL name VAL óscar e. vizcaíno	COL name VAL óscar vizcaíno	1
COL name VAL óscar c. vizcaíno	COL name VAL óscar vizcaíno	1
COL name VAL óscar v. vizcaíno	COL name VAL óscar vizcaíno	1
COL name VAL óscar r. vizcaíno	COL name VAL óscar vizcaíno	1
COL name VAL valeria t  antolino	COL name VAL valeria antolino	1
COL name VAL gustavo c  huertas	COL name VAL gustavo huertas	1
COL name VAL eysteinn s. erlendsson	COL name VAL eysteinn erlendsson	1
COL name VAL eysteinn o  erlendsson	COL name VAL eysteinn erlendsson	1
COL name VAL eysteinn p  erlendsson	COL name VAL eysteinn erlendsson	1
COL name VAL eysteinn f  erlendsson	COL name VAL eysteinn erlendsson	1
COL name VAL pål a. johannessen	COL name VAL pål johannessen	1
COL name VAL petter g  olsen	COL name VAL petter olsen	1
COL name VAL yōhei d. miyake	COL name VAL yōhei miyake	1
COL name VAL yōhei i. miyake	COL name VAL yōhei miyake	1
COL name VAL akinsola c. akinyemi	COL name VAL akinsola akinyemi	1
COL name VAL akinsola p. akinyemi	COL name VAL akinsola akinyemi	1
COL name VAL dilşad m  şimşek	COL name VAL dilşad şimşek	1
COL name VAL renee d. ginsberg	COL name VAL renee ginsberg	1
COL name VAL renee g. rabinowitz	COL name VAL renee rabinowitz	1
COL name VAL umberto a  cordani	COL name VAL umberto cordani	1
COL name VAL francisco a  lucini	COL name VAL francisco lucini	1
COL name VAL francisco j. lucini	COL name VAL francisco lucini	1
COL name VAL juan m. pulido	COL name VAL juan pulido	1
COL name VAL yolanda t. heras	COL name VAL yolanda heras	1
COL name VAL blanca m  hualde	COL name VAL blanca hualde	1
COL name VAL maria f. suñol	COL name VAL maria suñol	1
COL name VAL maria p  suñol	COL name VAL maria suñol	1
COL name VAL maria o. suñol	COL name VAL maria suñol	1
COL name VAL maria f  suñol	COL name VAL maria suñol	1
COL name VAL yossi p. peled	COL name VAL yossi peled	1
COL name VAL yossi r. peled	COL name VAL yossi peled	1
COL name VAL alexis e. scholl	COL name VAL alexis scholl	1
COL name VAL andreas s  hanche-olsen	COL name VAL andreas hanche-olsen	1
COL name VAL vinny j  lauwers	COL name VAL vinny lauwers	1
COL name VAL alexis t  lefrançois	COL name VAL alexis lefrançois	1
COL name VAL maría victoria e. mateos	COL name VAL maría victoria mateos	1
COL name VAL maría victoria c. mateos	COL name VAL maría victoria mateos	1
COL name VAL delfina l. entrecanales	COL name VAL delfina entrecanales	1
COL name VAL delfina l  entrecanales	COL name VAL delfina entrecanales	1
COL name VAL henrik t. christiansen	COL name VAL henrik christiansen	1
COL name VAL henrik m. christiansen	COL name VAL henrik christiansen	1
COL name VAL jakob n  bagge	COL name VAL jakob bagge	1
COL name VAL håvard a. nybø	COL name VAL håvard nybø	1
COL name VAL emil j  filliol	COL name VAL emil filliol	1
COL name VAL erik f  steen	COL name VAL erik steen	1
COL name VAL magnus s. grødem	COL name VAL magnus grødem	1
COL name VAL marcella l  jackson	COL name VAL marcella jackson	1
COL name VAL mary h. jackson	COL name VAL mary jackson	1
COL name VAL marcella b. jackson	COL name VAL marcella jackson	1
COL name VAL mary e. jackson	COL name VAL mary jackson	1
COL name VAL pol t. lozano	COL name VAL pol lozano	1
COL name VAL claudia i  cividino	COL name VAL claudia cividino	1
COL name VAL claudia j. cividino	COL name VAL claudia cividino	1
COL name VAL cristina a. montijano	COL name VAL cristina montijano	1
COL name VAL juan a. jiménez	COL name VAL juan jiménez	1
COL name VAL genaro t  gamboa	COL name VAL genaro gamboa	1
COL name VAL gabriel é. jiménez	COL name VAL gabriel jiménez	1
COL name VAL erik s  wollen	COL name VAL erik wollen	1
COL name VAL carolina m  montijano	COL name VAL carolina montijano	1
COL name VAL andré r. christiansen	COL name VAL andré christiansen	1
COL name VAL andré l  christiansen	COL name VAL andré christiansen	1
COL name VAL sven l. kristiansen	COL name VAL sven kristiansen	1
COL name VAL peter a  schärer	COL name VAL peter schärer	1
COL name VAL samy a  mmaee	COL name VAL samy mmaee	1
COL name VAL morten m. solvik	COL name VAL morten solvik	1
COL name VAL morten a. solvik	COL name VAL morten solvik	1
COL name VAL iselin j. solheim	COL name VAL iselin solheim	1
COL name VAL maria j  sarro	COL name VAL maria sarro	1
COL name VAL maria a. sarro	COL name VAL maria sarro	1
COL name VAL maria s. sarro	COL name VAL maria sarro	1
COL name VAL maria m  sarro	COL name VAL maria sarro	1
COL name VAL maria m  martinetti	COL name VAL maria martinetti	1
COL name VAL maria r. martinetti	COL name VAL maria martinetti	1
COL name VAL maria i  martinetti	COL name VAL maria martinetti	1
COL name VAL henry m. loos	COL name VAL henry loos	1
COL name VAL javier j. esparza	COL name VAL javier esparza	1
COL name VAL javier j  esparza	COL name VAL javier esparza	1
COL name VAL jorge f. garcía	COL name VAL jorge garcía	1
COL name VAL jorge j. garcía	COL name VAL jorge garcía	1
COL name VAL hans j. aune	COL name VAL hans aune	1
COL name VAL aurelio a. archinti	COL name VAL aurelio archinti	1
COL name VAL albert g. sambi lokonga	COL name VAL albert sambi lokonga	1
COL name VAL jean-claude e. clari	COL name VAL jean-claude clari	1
COL name VAL delia l  valeri	COL name VAL delia valeri	1
COL name VAL delia b  valeri	COL name VAL delia valeri	1
COL name VAL delia t  valeri	COL name VAL delia valeri	1
COL name VAL maria c. echezarreta	COL name VAL maria echezarreta	1
COL name VAL maria p  echezarreta	COL name VAL maria echezarreta	1
COL name VAL ivan a. galar	COL name VAL ivan galar	1
COL name VAL ivan s. galar	COL name VAL ivan galar	1
COL name VAL pat a  le paulmier	COL name VAL pat le paulmier	1
COL name VAL pat j  le paulmier	COL name VAL pat le paulmier	1
COL name VAL marcel f. flückiger	COL name VAL marcel flückiger	1
COL name VAL heinz a  lüdi	COL name VAL heinz lüdi	1
COL name VAL chris d  christenson	COL name VAL chris christenson	1
COL name VAL marguerite m. sechehaye	COL name VAL marguerite sechehaye	1
COL name VAL marguerite l  sechehaye	COL name VAL marguerite sechehaye	1
COL name VAL marguerite h. sechehaye	COL name VAL marguerite sechehaye	1
COL name VAL rené g. gillard	COL name VAL rené gillard	1
COL name VAL domenico e  pozzoni	COL name VAL domenico pozzoni	1
COL name VAL jostein j. gundersen	COL name VAL jostein gundersen	1
COL name VAL miriam s. pucci	COL name VAL miriam pucci	1
COL name VAL michele m. rossi	COL name VAL michele rossi	1
COL name VAL jeroen l  van den broeck	COL name VAL jeroen van den broeck	1
COL name VAL markus a  wüst	COL name VAL markus wüst	1
COL name VAL stefano c  merlino	COL name VAL stefano merlino	1
COL name VAL stefano f  merlino	COL name VAL stefano merlino	1
COL name VAL stefano d  merlino	COL name VAL stefano merlino	1
COL name VAL mickaël p. tırpan	COL name VAL mickaël tırpan	1
COL name VAL mickaël d  tırpan	COL name VAL mickaël tırpan	1
COL name VAL maría s. barja	COL name VAL maría barja	1
COL name VAL maría j  romay	COL name VAL maría romay	1
COL name VAL josé manuel n  gutiérrez	COL name VAL josé manuel gutiérrez	1
COL name VAL josé manuel j  gutiérrez	COL name VAL josé manuel gutiérrez	1
COL name VAL isabel d. rodríguez	COL name VAL isabel rodríguez	1
COL name VAL henry b. vollmer	COL name VAL henry vollmer	1
COL name VAL john p  schutz	COL name VAL john schutz	1
COL name VAL cristina d  barja	COL name VAL cristina barja	1
COL name VAL cristina n. romay	COL name VAL cristina romay	1
COL name VAL pasqualina c. sarro	COL name VAL pasqualina sarro	1
COL name VAL pasqualina a  sarro	COL name VAL pasqualina sarro	1
COL name VAL pasqualina k. sarro	COL name VAL pasqualina sarro	1
COL name VAL pasqualina j. sarro	COL name VAL pasqualina sarro	1
COL name VAL johan a. bollen	COL name VAL johan bollen	1
COL name VAL johan e. bollen	COL name VAL johan bollen	1
COL name VAL johan s. bollen	COL name VAL johan bollen	1
COL name VAL johan d  bollen	COL name VAL johan bollen	1
COL name VAL johan m. bollen	COL name VAL johan bollen	1
COL name VAL johan e  bollen	COL name VAL johan bollen	1
COL name VAL john c  granrud	COL name VAL john granrud	1
COL name VAL john w  granrud	COL name VAL john granrud	1
COL name VAL gabriele j. gresta	COL name VAL gabriele gresta	1
COL name VAL gabriele f. gresta	COL name VAL gabriele gresta	1
COL name VAL manuel f  martos	COL name VAL manuel martos	1
COL name VAL manuel l. parra	COL name VAL manuel parra	1
COL name VAL nilde r. baracchi	COL name VAL nilde baracchi	1
COL name VAL frantz j. hofmann	COL name VAL frantz hofmann	1
COL name VAL lorena r. villa	COL name VAL lorena villa	1
COL name VAL andré r  verdeil	COL name VAL andré verdeil	1
COL name VAL markus j. nüssli	COL name VAL markus nüssli	1
COL name VAL tom j. pietermaat	COL name VAL tom pietermaat	1
COL name VAL giovanni m  bianchi	COL name VAL giovanni bianchi	1
COL name VAL rudolf d. keller	COL name VAL rudolf keller	1
COL name VAL f. a  froment	COL name VAL f. froment	1
COL name VAL gilbert d. froment	COL name VAL gilbert froment	1
COL name VAL f. l. froment	COL name VAL f. froment	1
COL name VAL gilbert s  froment	COL name VAL gilbert froment	1
COL name VAL jean o. neuhaus	COL name VAL jean neuhaus	1
COL name VAL carolina e. wolters	COL name VAL carolina wolters	1
COL name VAL álvaro y  herreros	COL name VAL álvaro herreros	1
COL name VAL álvaro w  herreros	COL name VAL álvaro herreros	1
COL name VAL julián c. martínez	COL name VAL julián martínez	1
COL name VAL roberto r. encinas	COL name VAL roberto encinas	1
COL name VAL ruedi d  keller	COL name VAL ruedi keller	1
COL name VAL chris j  van puyvelde	COL name VAL chris van puyvelde	1
COL name VAL bernhard j  müller	COL name VAL bernhard müller	1
COL name VAL miguel ángel c  rubio	COL name VAL miguel ángel rubio	1
COL name VAL modesto m  romero	COL name VAL modesto romero	1
COL name VAL chloé e  van de velde	COL name VAL chloé van de velde	1
COL name VAL chloé m  van de velde	COL name VAL chloé van de velde	1
COL name VAL chloé w  van de velde	COL name VAL chloé van de velde	1
COL name VAL joana m. garcía	COL name VAL joana garcía	1
COL name VAL david m  campos	COL name VAL david campos	1
COL name VAL zeno b. moser	COL name VAL zeno moser	1
COL name VAL dominic j. pozzoni	COL name VAL dominic pozzoni	1
COL name VAL domingo d. campos	COL name VAL domingo campos	1
COL name VAL jørn h. stubberud	COL name VAL jørn stubberud	1
COL name VAL jürg t  wegelin	COL name VAL jürg wegelin	1
COL name VAL willy h  schäfer	COL name VAL willy schäfer	1
COL name VAL filippo d  rusuti	COL name VAL filippo rusuti	1
COL name VAL filippo d  rusuti	COL name VAL filippo rusuti	1
COL name VAL filippo d  rusuti	COL name VAL filippo rusuti	1
COL name VAL filippo j  rusuti	COL name VAL filippo rusuti	1
COL name VAL filippo j. rusuti	COL name VAL filippo rusuti	1
COL name VAL filippo m. rusuti	COL name VAL filippo rusuti	1
COL name VAL filippo s  rusuti	COL name VAL filippo rusuti	1
COL name VAL belisario j  acquaviva	COL name VAL belisario acquaviva	1
COL name VAL antonio d  gandini	COL name VAL antonio gandini	1
COL name VAL paolo a  roero	COL name VAL paolo roero	1
COL name VAL vincenzo a  roero	COL name VAL vincenzo roero	1
COL name VAL riccardo j. grassetti	COL name VAL riccardo grassetti	1
COL name VAL fritz m  schäublin	COL name VAL fritz schäublin	1
COL name VAL walter f. dürst	COL name VAL walter dürst	1
COL name VAL üli n. hofmann	COL name VAL üli hofmann	1
COL name VAL henry d. negretti	COL name VAL henry negretti	1
COL name VAL henry s  negretti	COL name VAL henry negretti	1
COL name VAL henry n. negretti	COL name VAL henry negretti	1
COL name VAL celestino j  pancheri	COL name VAL celestino pancheri	1
COL name VAL rené a. deck	COL name VAL rené deck	1
COL name VAL rené r. bader	COL name VAL rené bader	1
COL name VAL alessandro s. benassi	COL name VAL alessandro benassi	1
COL name VAL alessandro p  benassi	COL name VAL alessandro benassi	1
COL name VAL francesco w. barbieri	COL name VAL francesco barbieri	1
COL name VAL francesco j  barbieri	COL name VAL francesco barbieri	1
COL name VAL francesco m. barbieri	COL name VAL francesco barbieri	1
COL name VAL francesco v  barbieri	COL name VAL francesco barbieri	1
COL name VAL francesco t. barbieri	COL name VAL francesco barbieri	1
COL name VAL francesco j. barbieri	COL name VAL francesco barbieri	1
COL name VAL francesco s. barbieri	COL name VAL francesco barbieri	1
COL name VAL edwin j. bryant	COL name VAL edwin bryant	1
COL name VAL edwin n  bryant	COL name VAL edwin bryant	1
COL name VAL edwin c  bryant	COL name VAL edwin bryant	1
COL name VAL marius f. larsen	COL name VAL marius larsen	1
COL name VAL kristoffer h  klaesson	COL name VAL kristoffer klaesson	1
COL name VAL catherine k  verleysen	COL name VAL catherine verleysen	1
COL name VAL alfredo i  fioravanti	COL name VAL alfredo fioravanti	1
COL name VAL andreas n  ton	COL name VAL andreas ton	1
COL name VAL ronald j. de sousa	COL name VAL ronald de sousa	1
COL name VAL felix j  myhre	COL name VAL felix myhre	1
COL name VAL therese h. åsland	COL name VAL therese åsland	1
COL name VAL jésus y. barreda	COL name VAL jésus barreda	1
COL name VAL jésus j. barreda	COL name VAL jésus barreda	1
COL name VAL yossi k  hadar	COL name VAL yossi hadar	1
COL name VAL andy e  ton	COL name VAL andy ton	1
COL name VAL maria m  barreda	COL name VAL maria barreda	1
COL name VAL maria p. barreda	COL name VAL maria barreda	1
COL name VAL karl e. kälin	COL name VAL karl kälin	1
COL name VAL patrick i. bühlmann	COL name VAL patrick bühlmann	1
COL name VAL manuel f. fernández	COL name VAL manuel fernández	1
COL name VAL tomás c. fernández	COL name VAL tomás fernández	1
COL name VAL élisabeth k  duparc	COL name VAL élisabeth duparc	1
COL name VAL justin b. vulliamy	COL name VAL justin vulliamy	1
COL name VAL bettina d. kühn	COL name VAL bettina kühn	1
COL name VAL lars s  schjetne	COL name VAL lars schjetne	1
COL name VAL lars s. schjetne	COL name VAL lars schjetne	1
COL name VAL lars a  schjetne	COL name VAL lars schjetne	1
COL name VAL jakob f  tromsdal	COL name VAL jakob tromsdal	1
COL name VAL jakob j  tromsdal	COL name VAL jakob tromsdal	1
COL name VAL rikke j  nygard	COL name VAL rikke nygard	1
COL name VAL rikke l. bogetveit	COL name VAL rikke bogetveit	1
COL name VAL gabrielle h  lie	COL name VAL gabrielle lie	1
COL name VAL gabrielle t  lie	COL name VAL gabrielle lie	1
COL name VAL mia b  huse	COL name VAL mia huse	1
COL name VAL guido l. pizarro	COL name VAL guido pizarro	1
COL name VAL alexandre j. crépet	COL name VAL alexandre crépet	1
COL name VAL michelangelo m. di pietro	COL name VAL michelangelo di pietro	1
COL name VAL michelangelo j. di pietro	COL name VAL michelangelo di pietro	1
COL name VAL michelangelo h  di pietro	COL name VAL michelangelo di pietro	1
COL name VAL michelangelo g  di pietro	COL name VAL michelangelo di pietro	1
COL name VAL pietro m. adami	COL name VAL pietro adami	1
COL name VAL diego h  da silva	COL name VAL diego da silva	1
COL name VAL diego r  giaretta	COL name VAL diego giaretta	1
COL name VAL erwan g. käser	COL name VAL erwan käser	1
COL name VAL philippe k  fauchet	COL name VAL philippe fauchet	1
COL name VAL max h  fauchet	COL name VAL max fauchet	1
COL name VAL philippe p  fauchet	COL name VAL philippe fauchet	1
COL name VAL max a  fauchet	COL name VAL max fauchet	1
COL name VAL kim-joy r  hewlett	COL name VAL kim-joy hewlett	1
COL name VAL kim-joy e  hewlett	COL name VAL kim-joy hewlett	1
COL name VAL klara k. sporsem	COL name VAL klara sporsem	1
COL name VAL friedrich e. sustris	COL name VAL friedrich sustris	1
COL name VAL friedrich a  sustris	COL name VAL friedrich sustris	1
COL name VAL friedrich b. sustris	COL name VAL friedrich sustris	1
COL name VAL friedrich d  sustris	COL name VAL friedrich sustris	1
COL name VAL friedrich l  sustris	COL name VAL friedrich sustris	1
COL name VAL friedrich g. sustris	COL name VAL friedrich sustris	1
COL name VAL friedrich m. sustris	COL name VAL friedrich sustris	1
COL name VAL friedrich e. sustris	COL name VAL friedrich sustris	1
COL name VAL friedrich r  sustris	COL name VAL friedrich sustris	1
COL name VAL friedrich q. sustris	COL name VAL friedrich sustris	1
COL name VAL friedrich t  sustris	COL name VAL friedrich sustris	1
COL name VAL friedrich r  sustris	COL name VAL friedrich sustris	1
COL name VAL friedrich s  sustris	COL name VAL friedrich sustris	1
COL name VAL friedrich s  sustris	COL name VAL friedrich sustris	1
COL name VAL friedrich j. sustris	COL name VAL friedrich sustris	1
COL name VAL friedrich m. sustris	COL name VAL friedrich sustris	1
COL name VAL friedrich a. sustris	COL name VAL friedrich sustris	1
COL name VAL friedrich m. sustris	COL name VAL friedrich sustris	1
COL name VAL friedrich d. sustris	COL name VAL friedrich sustris	1
COL name VAL friedrich j. sustris	COL name VAL friedrich sustris	1
COL name VAL peter m  müller	COL name VAL peter müller	1
COL name VAL blanche r. charlet	COL name VAL blanche charlet	1
COL name VAL valentine g  charlet	COL name VAL valentine charlet	1
COL name VAL carl h. colpaert	COL name VAL carl colpaert	1
COL name VAL tancrède ş  dumas	COL name VAL tancrède dumas	1
COL name VAL tancrède j. dumas	COL name VAL tancrède dumas	1
COL name VAL tancrède t  dumas	COL name VAL tancrède dumas	1
COL name VAL tancrède j  dumas	COL name VAL tancrède dumas	1
COL name VAL tancrède p  dumas	COL name VAL tancrède dumas	1
COL name VAL nico d  brüngger	COL name VAL nico brüngger	1
COL name VAL nico a. brüngger	COL name VAL nico brüngger	1
COL name VAL gregory l  wüthrich	COL name VAL gregory wüthrich	1
COL name VAL arthur t  varney	COL name VAL arthur varney	1
COL name VAL arthur l. varney	COL name VAL arthur varney	1
COL name VAL gaetano r. mignani	COL name VAL gaetano mignani	1
COL name VAL heidi b. ellingsen	COL name VAL heidi ellingsen	1
COL name VAL frode m  hegland	COL name VAL frode hegland	1
COL name VAL alexander s  hegland	COL name VAL alexander hegland	1
COL name VAL agustín c. garcía	COL name VAL agustín garcía	1
COL name VAL rodrigo é. de borja	COL name VAL rodrigo de borja	1
COL name VAL julián r  lópez	COL name VAL julián lópez	1
COL name VAL julián t. lópez	COL name VAL julián lópez	1
COL name VAL otto a  bühler	COL name VAL otto bühler	1
COL name VAL otto f. bühler	COL name VAL otto bühler	1
COL name VAL otto f. schläpfer	COL name VAL otto schläpfer	1
COL name VAL ralph d. rüegg	COL name VAL ralph rüegg	1
COL name VAL andré j. niederhäuser	COL name VAL andré niederhäuser	1
COL name VAL valentina w. bosetti	COL name VAL valentina bosetti	1
COL name VAL umberto l. romano	COL name VAL umberto romano	1
COL name VAL leonarda j. casiraghi	COL name VAL leonarda casiraghi	1
COL name VAL george j  molteno	COL name VAL george molteno	1
COL name VAL george v. molteno	COL name VAL george molteno	1
COL name VAL gianfranco m  felli	COL name VAL gianfranco felli	1
COL name VAL eva a. rønning	COL name VAL eva rønning	1
COL name VAL eva l  fodor	COL name VAL eva fodor	1
COL name VAL gret á. mann	COL name VAL gret mann	1
COL name VAL gret s  moser	COL name VAL gret moser	1
COL name VAL jorunn m  buckley	COL name VAL jorunn buckley	1
COL name VAL jorunn w. buckley	COL name VAL jorunn buckley	1
COL name VAL jorunn m  buckley	COL name VAL jorunn buckley	1
COL name VAL joan i  massagué	COL name VAL joan massagué	1
COL name VAL joan h  massagué	COL name VAL joan massagué	1
COL name VAL joan t  massagué	COL name VAL joan massagué	1
COL name VAL joan p. massagué	COL name VAL joan massagué	1
COL name VAL david h  rodrigo	COL name VAL david rodrigo	1
COL name VAL miguel ángel ø  araújo iglesias	COL name VAL miguel ángel araújo iglesias	1
COL name VAL josé manuel s  egea	COL name VAL josé manuel egea	1
COL name VAL joaquín l. novoa	COL name VAL joaquín novoa	1
COL name VAL rodolphe r  cuendet	COL name VAL rodolphe cuendet	1
COL name VAL silvan l. büchli	COL name VAL silvan büchli	1
COL name VAL henry j  müller	COL name VAL henry müller	1
COL name VAL leo y. pescarolo	COL name VAL leo pescarolo	1
COL name VAL dany w. da silva	COL name VAL dany da silva	1
COL name VAL petra l  walczewski	COL name VAL petra walczewski	1
COL name VAL marie w  aubert	COL name VAL marie aubert	1
COL name VAL mercia c. harrison	COL name VAL mercia harrison	1
COL name VAL martin m  tschudy	COL name VAL martin tschudy	1
COL name VAL martin r. tschudi	COL name VAL martin tschudi	1
COL name VAL mercia m  tinker	COL name VAL mercia tinker	1
COL name VAL josé r  santiago concha	COL name VAL josé santiago concha	1
COL name VAL antonio d  jiménez	COL name VAL antonio jiménez	1
COL name VAL nathaniel m  andré	COL name VAL nathaniel andré	1
COL name VAL carlos l. arroyo	COL name VAL carlos arroyo	1
COL name VAL adolfo r  prada	COL name VAL adolfo prada	1
COL name VAL julien f  livi	COL name VAL julien livi	1
COL name VAL manfredi j. lefebvre	COL name VAL manfredi lefebvre	1
COL name VAL manfredi a. lefebvre	COL name VAL manfredi lefebvre	1
COL name VAL manfredi p. lefebvre	COL name VAL manfredi lefebvre	1
COL name VAL elsa esnoult de michael je taime j  horváth	COL name VAL elsa esnoult de michael je taime horváth	1
COL name VAL elsa esnoult de michael je taime c. horváth	COL name VAL elsa esnoult de michael je taime horváth	1
COL name VAL markus m  bösiger	COL name VAL markus bösiger	1
COL name VAL conrad m. buff	COL name VAL conrad buff	1
COL name VAL conrad r  buff	COL name VAL conrad buff	1
COL name VAL joão g. oliveira	COL name VAL joão oliveira	1
COL name VAL e. m  garcin	COL name VAL e. garcin	1
COL name VAL e. j. garcin	COL name VAL e. garcin	1
COL name VAL francine t. lacqua	COL name VAL francine lacqua	1
COL name VAL kat j  arney	COL name VAL kat arney	1
COL name VAL sarah l  suphellen	COL name VAL sarah suphellen	1
COL name VAL sarah e  suphellen	COL name VAL sarah suphellen	1
COL name VAL michael r. wollan	COL name VAL michael wollan	1
COL name VAL lars t  olson	COL name VAL lars olson	1
COL name VAL jens r  opsahl	COL name VAL jens opsahl	1
COL name VAL john t  oppegaard	COL name VAL john oppegaard	1
COL name VAL auguste j. garcin	COL name VAL auguste garcin	1
COL name VAL auguste m  garcin	COL name VAL auguste garcin	1
COL name VAL josé a  espelius	COL name VAL josé espelius	1
